,count(p.gender),FemaleCount,MaleCount,OtherCount,title,year,Female+Male
0,8,3,5,0,Alam Ara,1931,8
1,13,5,8,0,Achhut Kanya,1936,
2,20,11,9,0,Devdas,1936,
3,10,3,7,0,Sant Tukaram,1936,
4,44,17,27,0,The Little Princess,1939,
5,53,7,46,0,Footsteps in the Dark,1941,
6,13,3,10,0,Kismet,1943,
7,10,3,7,0,Dr. Kotnis Ki Amar Kahani,1946,
8,8,3,5,0,Neecha Nagar,1946,
9,8,5,3,0,Jugnu,1947,
10,11,6,5,0,Neel Kamal,1947,
11,13,5,8,0,Aag,1948,
12,13,3,10,0,Mela,1948,
13,6,2,4,0,Shaheed,1948,
14,11,4,7,0,Andaz,1949,
15,12,5,7,0,Barsaat,1949,
16,17,6,11,0,Mahal,1949,
17,10,6,4,0,Jogan,1950,
18,30,7,23,0,The 20 Questions Murder Mystery,1950,
19,11,5,6,0,Albela,1951,
20,17,8,9,0,Awaara,1951,
21,12,3,9,0,Baazi,1951,
22,14,6,8,0,Deedar,1951,
23,10,3,7,0,Tarana,1951,
24,104,12,92,0,The Day the Earth Stood Still,1951,
25,11,6,5,0,Aan,1952,
26,18,5,13,0,Anand Math,1952,
27,18,5,13,0,Baiju Bawra,1952,
28,10,4,6,0,Daag,1952,
29,8,3,5,0,Jaal,1952,
30,6,4,2,0,Sangdil,1952,
31,9,4,5,0,Aah,1953,
32,7,4,3,0,Anarkali,1953,
33,14,5,9,0,Baaz,1953,
34,50,16,34,0,Do Bigha Zamin,1953,
35,30,8,22,0,Jhansi Ki Rani,1953,
36,31,12,19,0,Parineeta,1953,
37,12,5,7,0,Patita,1953,
38,53,15,38,0,Thunder in the East,1953,
39,13,6,7,0,Aar-Paar,1954,
40,16,3,13,0,Amar,1954,
41,10,3,7,0,Boot Polish,1954,
42,11,4,7,0,Mirza Ghalib,1954,
43,6,3,3,0,Naukari,1954,
44,15,3,12,0,Taxi Driver,1954,
45,15,6,9,0,Azaad,1955,
46,30,13,17,0,Devdas,1955,
47,13,5,8,0,House No. 44,1955,
48,10,4,6,0,Insaniyat,1955,
49,6,3,3,0,Jhanak Jhanak Payal Baaje,1955,
50,18,9,9,0,Mr. & Mrs. '55,1955,
51,8,3,5,0,Munimji,1955,
52,16,6,10,0,Seema,1955,
53,24,9,15,0,Shree 420,1955,
54,15,6,9,0,C.I.D.,1956,
55,12,5,7,0,Chori Chori,1956,
56,11,4,7,0,Funtoosh,1956,
57,21,3,18,0,Jagriti,1956,
58,30,6,24,0,Jagte Raho,1956,
59,20,5,15,0,New Delhi,1956,
60,24,2,22,0,Ab Dilli Dur Nahin,1957,
61,17,4,13,0,Apradhi Kaun?,1957,
62,14,2,12,0,Do Ankhen Barah Haath,1957,
63,36,13,23,0,Maya Bazaar,1957,
64,18,7,11,0,Mother India,1957,
65,17,8,9,0,Musafir,1957,
66,10,5,5,0,Nau Do Gyarah,1957,
67,24,8,16,0,Naya Daur,1957,
68,13,6,7,0,Pardesi,1957,
69,13,4,9,0,Paying Guest,1957,
70,15,7,8,0,Pyaasa,1957,
71,16,8,8,0,Sharada,1957,
72,12,4,8,0,Tumsa Nahin Dekha,1957,
73,85,22,63,0,Auntie Mame,1958,
74,12,7,5,0,Bhookailas,1958,
75,12,5,7,0,Chalti Ka Naam Gaadi,1958,
76,12,4,8,0,Howrah Bridge,1958,
77,18,5,13,0,Kala Pani,1958,
78,15,1,14,0,Madhumati,1958,
79,9,3,6,0,Phir Subha Hogi,1958,
80,17,6,11,0,Solva Saal,1958,
81,17,9,8,0,Yahudi,1958,
82,18,8,10,0,Anari,1959,
83,20,7,13,0,Dhool Ka Phool,1959,
84,14,4,10,0,Dil Deke Dekho,1959,
85,16,10,6,0,Kaagaz Ke Phool,1959,
86,9,2,7,0,Navrang,1959,
87,22,3,19,0,North West Frontier,1959,
88,15,1,14,0,Anuradha,1960,
89,25,9,16,0,Barsaat Ki Raat,1960,
90,13,7,6,0,Bombai Ka Babu,1960,
91,27,14,13,0,Chaudhvin Ka Chand,1960,
92,5,2,3,0,Chhalia,1960,
93,15,9,6,0,Dil Apna Aur Preet Parai,1960,
94,14,5,9,0,Jaali Note,1960,
95,20,6,14,0,Jis Desh Men Ganga Behti Hai,1960,
96,37,12,25,0,Kala Bazar,1960,
97,8,3,5,0,Kanoon,1960,
98,19,7,12,0,Kohinoor,1960,
99,11,5,6,0,Love in Simla,1960,
100,31,9,22,0,Parakh,1960,
101,19,7,12,0,Sujata,1960,
102,28,8,20,0,Dharmputra,1961,
103,37,10,27,0,Gunga Jumna,1961,
104,15,5,10,0,Hum Dono,1961,
105,10,3,7,0,Jab Pyar Kisise Hota Hai,1961,
106,20,8,12,0,Jhumroo,1961,
107,15,6,9,0,Junglee,1961,
108,21,11,10,0,Kabuliwala,1961,
109,41,13,28,0,Anpadh,1962,
110,19,8,11,0,Asli-Naqli,1962,
111,8,3,5,0,Baat Ek Raat Ki,1962,
112,18,3,15,0,Bees Saal Baad,1962,
113,28,8,20,0,China Town,1962,
114,11,6,5,0,Dil Tera Diwana,1962,
115,20,7,13,0,Half Ticket,1962,
116,13,5,8,0,Hariyali Aur Rasta,1962,
117,20,6,14,0,Naughty Boy,1962,
118,27,14,13,0,Prem Patra,1962,
119,13,7,6,0,Professor,1962,
120,16,5,11,0,Sahib Bibi Aur Ghulam,1962,
121,44,16,28,0,Bandini,1963,
122,5,1,4,0,Bhootnath,1963,
123,11,3,8,0,Bluff Master,1963,
124,10,4,6,0,Dil Ek Mandir,1963,
125,12,6,6,0,Dil Hi To Hai,1963,
126,6,3,3,0,Gumrah,1963,
127,16,8,8,0,Mere Mehboob,1963,
128,42,9,33,0,Mujhe Jeene Do,1963,
129,13,6,7,0,Phir Wohi Dil Laya Hoon,1963,
130,16,8,8,0,Tere Ghar Ke Samne,1963,
131,11,6,5,0,Ayee Milan Ki Bela,1964,
132,17,8,9,0,Chitralekha,1964,
133,11,4,7,0,Dosti,1964,
134,11,4,7,0,Dulha Dulhan,1964,
135,13,4,9,0,Geet Gaaya Pattharon Ne,1964,
136,32,8,24,0,Haqeeqat,1964,
137,20,9,11,0,Kashmir Ki Kali,1964,
138,10,3,7,0,Kohraa,1964,
139,37,7,30,0,Leader,1964,
140,14,5,9,0,Mr. X in Bombay,1964,
141,11,5,6,0,Rajkumar,1964,
142,7,3,4,0,Sangam,1964,
143,9,4,5,0,Sharabi,1964,
144,15,6,9,0,Woh Kaun Thi?,1964,
145,2,1,1,0,Yaadein,1964,
146,21,9,12,0,Arzoo,1965,
147,20,5,15,0,Bhoot Bungla,1965,
148,14,6,8,0,Chemmeen,1965,
149,19,7,12,0,Guide,1965,
150,14,5,9,0,Gumnaam,1965,
151,16,6,10,0,Himalay Ki Godmein,1965,
152,11,6,5,0,Jab Jab Phool Khile,1965,
153,24,11,13,0,Janwar,1965,
154,21,9,12,0,Kaajal,1965,
155,12,6,6,0,Khandan,1965,
156,33,7,26,0,Shaheed,1965,
157,12,5,7,0,Shakespeare-Wallah,1965,
158,15,5,10,0,Teen Devian,1965,
159,24,6,18,0,Waqt,1965,
160,14,4,10,0,Aakhri Khat,1966,
161,23,11,12,0,Aaye Din Bahar Ke,1966,
162,29,6,23,0,Amrapali,1966,
163,19,6,13,0,Anupama,1966,
164,18,7,11,0,Baharen Phir Bhi Aayengi,1966,
165,10,5,5,0,Budtameez,1966,
166,25,12,13,0,Devar,1966,
167,30,6,24,0,Dil Diya Dard Liya,1966,
168,10,4,6,0,Do Badan,1966,
169,13,4,9,0,Love in Tokyo,1966,
170,12,4,8,0,Mamta,1966,
171,15,2,13,0,Mera Saaya,1966,
172,45,15,30,0,Phool Aur Patthar,1966,
173,9,4,5,0,Pyar Kiye Jaa,1966,
174,12,7,5,0,Saraswathi Sabatham,1966,
175,15,6,9,0,Suraj,1966,
176,27,7,20,0,Teesri Kasam,1966,
177,24,9,15,0,Teesri Manzil,1966,
178,15,4,11,0,Aamne - Saamne,1967,
179,9,2,7,0,An Evening in Paris,1967,
180,19,6,13,0,Anita,1967,
181,9,3,6,0,Around the World,1967,
182,27,11,16,0,Baharon Ke Sapne,1967,
183,19,7,12,0,Bahu Begum,1967,
184,14,4,10,0,Diwana,1967,
185,22,3,19,0,Farz,1967,
186,25,6,19,0,Hamraaz,1967,
187,32,8,24,0,Jewel Thief,1967,
188,20,5,15,0,Majhli Didi,1967,
189,16,6,10,0,Milan,1967,
190,14,5,9,0,Patthar Ke Sanam,1967,
191,24,7,17,0,Pretty Polly,1967,
192,16,7,9,0,Raaz,1967,
193,22,9,13,0,Ram Aur Shyam,1967,
194,18,7,11,0,Shagird,1967,
195,37,11,26,0,The Long Duel,1967,
196,20,7,13,0,Upkar,1967,
197,11,4,7,0,Aadmi,1968,
198,27,11,16,0,Aashirwad,1968,
199,29,8,21,0,Ankhen,1968,
200,18,3,15,0,Anokhi Raat,1968,
201,34,12,22,0,Brahmachari,1968,
202,7,4,3,0,Do Dooni Char,1968,
203,12,8,4,0,Do Kaliyaan,1968,
204,4,3,1,0,Goa Dalli CID 999,1968,
205,14,2,12,0,Haseena Maan Jayegi,1968,
206,15,6,9,0,Izzat,1968,
207,28,6,22,0,Jhuk Gaya Aasman,1968,
208,23,13,10,0,Kanyadaan,1968,
209,18,6,12,0,Mere Hamdam Mere Dost,1968,
210,28,11,17,0,Neel Kamal,1968,
211,13,4,9,0,Padosan,1968,
212,12,7,5,0,Saathi,1968,
213,30,11,19,0,Sadhu Aur Shaitaan,1968,
214,9,4,5,0,Sapnon Ka Saudagar,1968,
215,26,15,11,0,Saraswatichandra,1968,
216,16,5,11,0,Shikar,1968,
217,31,11,20,0,Sunghursh,1968,
218,22,6,16,0,Aadmi Aur Insaan,1969,
219,32,7,25,0,Aradhana,1969,
220,27,9,18,0,Aya Sawan Jhoom Ke,1969,
221,16,6,10,0,Bandhan,1969,
222,6,2,4,0,Bhuvan Shome,1969,
223,24,6,18,0,Do Raaste,1969,
224,27,9,18,0,Ek Phool Do Mali,1969,
225,24,1,23,0,Gladiatorerna,1969,
226,12,4,8,0,Ittefaq,1969,
227,25,8,17,0,Jeene Ki Raah,1969,
228,21,8,13,0,Mahal,1969,
229,24,5,19,0,Prince,1969,
230,22,8,14,0,Pyar Ka Mausam,1969,
231,23,6,17,0,Saat Hindustani,1969,
232,28,6,22,0,Satyakam,1969,
233,47,20,27,0,Talash,1969,
234,25,9,16,0,Tumse Achha Kaun Hai,1969,
235,20,7,13,0,Yakeen,1969,
236,26,8,18,0,Aan Milo Sajna,1970,
237,18,5,13,0,Abhinetri,1970,
238,21,5,16,0,Dastak,1970,
239,10,5,5,0,Geet,1970,
240,22,9,13,0,Ghar Ghar Ki Kahani,1970,
241,15,6,9,0,Gopi,1970,
242,50,27,23,0,Heer Raanjha,1970,
243,15,6,9,0,Humjoli,1970,
244,19,3,16,0,Jeevan Mrityu,1970,
245,26,6,20,0,Johny Mera Naam,1970,
246,18,4,14,0,Kab? Kyoon? Aur Kahan?,1970,
247,21,8,13,0,Kati Patang,1970,
248,13,4,9,0,Khamoshi,1970,
249,26,10,16,0,Khilona,1970,
250,25,5,20,0,Mera Naam Joker,1970,
251,28,5,23,0,Pagla Kahin Ka,1970,
252,22,4,18,0,Prem Pujari,1970,
253,21,7,14,0,Purab Aur Pachhim,1970,
254,18,6,12,0,Sachaa Jhutha,1970,
255,14,3,11,0,Safar,1970,
256,34,11,23,0,Sharafat,1970,
257,27,7,20,0,The Train,1970,
258,31,11,20,0,Tum Haseen Main Jawan,1970,
259,4,2,2,0,Uski Roti,1970,
260,18,7,11,0,Aap Aye Bahaar Ayee,1971,
261,17,6,11,0,Anand,1971,
262,12,5,7,0,Andaz,1971,
263,32,8,24,0,Anubhav,1971,
264,18,10,8,0,Buddha Mil Gaya,1971,
265,14,6,8,0,Caravan,1971,
266,37,8,29,0,Dushman,1971,
267,8,2,6,0,Fajr al islam,1971,
268,22,8,14,0,Gambler,1971,
269,37,11,26,0,Guddi,1971,
270,26,5,21,0,Haathi Mere Saathi,1971,
271,29,12,17,0,Haré Rama Haré Krishna,1971,
272,49,17,32,0,Hulchul,1971,
273,31,5,26,0,Kal Aaj Aur Kal,1971,
274,26,12,14,0,Lal Patthar,1971,
275,21,7,14,0,Mehboob Ki Mehndi,1971,
276,22,7,15,0,Mera Gaon Mera Desh,1971,
277,32,7,25,0,Mere Apne,1971,
278,14,6,8,0,Naya Zamana,1971,
279,19,7,12,0,Parwana,1971,
280,25,5,20,0,Pyar Ki Kahani,1971,
281,19,6,13,0,Reshma Aur Shera,1971,
282,32,11,21,0,Sharmeelee,1971,
283,30,9,21,0,Tere Mere Sapne,1971,
284,47,12,35,0,Amar Prem,1972,
285,21,6,15,0,Anuraag,1972,
286,14,3,11,0,Apna Desh,1972,
287,28,6,22,0,Apradh,1972,
288,13,5,8,0,Bawarchi,1972,
289,43,16,27,0,Be-Imaan,1972,
290,49,11,38,0,Bombay to Goa,1972,
291,28,6,22,0,Dastaan,1972,
292,11,4,7,0,Do Gaz Zameen Ke Neeche,1972,
293,26,6,20,0,Ek Nazar,1972,
294,18,5,13,0,Garam Masala,1972,
295,12,2,10,0,Gora Aur Kala,1972,
296,36,13,23,0,Jangal Mein Mangal,1972,
297,16,5,11,0,Jawani Diwani,1972,
298,17,6,11,0,Joroo Ka Ghulam,1972,
299,22,6,16,0,Koshish,1972,
300,33,4,29,0,Lalkar The Challenge,1972,
301,4,1,3,0,Maya Darpan,1972,
302,23,7,16,0,Mere Jeevan Saathi,1972,
303,19,5,14,0,Parichay,1972,
304,9,5,4,0,Pinjra,1972,
305,21,5,16,0,Piya Ka Ghar,1972,
306,22,7,15,0,Raaste Kaa Patthar,1972,
307,20,6,14,0,Raja Jani,1972,
308,20,6,14,0,Samadhi,1972,
309,19,6,13,0,Sanjog,1972,
310,25,7,18,0,Seeta Aur Geeta,1972,
311,24,9,15,0,Shor,1972,
312,24,10,14,0,Victoria No. 203,1972,
313,20,6,14,0,Aa Gale Lag Jaa,1973,
314,16,7,9,0,Aaj Ki Taaza Khabar,1973,
315,10,4,6,0,Abhimaan,1973,
316,14,3,11,0,Achanak,1973,
317,31,9,22,0,Anamika,1973,
318,21,6,15,0,Banarasi Babu,1973,
319,21,7,14,0,Bandhe Haath,1973,
320,19,4,15,0,Black Mail,1973,
321,24,13,11,0,Bobby,1973,
322,10,2,8,0,Chhupa Rustam,1973,
323,22,7,15,0,Daag: A Poem of Love,1973,
324,13,6,7,0,Dhund,1973,
325,7,1,6,0,Duvidha,1973,
326,10,1,9,0,Gehri Chaal,1973,
327,20,5,15,0,Hanste Zakhm,1973,
328,21,6,15,0,Heera Panna,1973,
329,12,2,10,0,Hindustan Ki Kasam,1973,
330,21,6,15,0,Jheel Ke Us Paar,1973,
331,27,10,17,0,Joshila,1973,
332,41,9,32,0,Jugnu,1973,
333,27,8,19,0,Kahani Kismat Ki,1973,
334,41,7,34,0,Loafer,1973,
335,16,9,7,0,Manchali,1973,
336,18,8,10,0,Namak Haraam,1973,
337,7,1,6,0,Padatik,1973,
338,29,10,19,0,Raja Rani,1973,
339,10,3,7,0,Saudagar,1973,
340,47,12,35,0,Yaadon Ki Baaraat,1973,
341,39,6,33,0,Zanjeer,1973,
342,7,2,5,0,27 Down,1974,
343,16,5,11,0,36 Ghante,1974,
344,20,7,13,0,Aap Ki Kasam,1974,
345,7,3,4,0,Aavishkar,1974,
346,27,7,20,0,Ajanabee,1974,
347,43,8,35,0,Amir Garib,1974,
348,24,5,19,0,Ankur,1974,
349,28,6,22,0,Benaam,1974,
350,19,4,15,0,Chor Machaye Shor,1974,
351,37,6,31,0,Dost,1974,
352,32,8,24,0,Garm Hava,1974,
353,16,2,14,0,Haath Ki Safai,1974,
354,31,11,20,0,Ishq Ishq Ishq,1974,
355,29,4,25,0,Kasauti,1974,
356,15,4,11,0,Khhotte Sikkay,1974,
357,15,7,8,0,Kora Kagaz,1974,
358,20,5,15,0,Kunwara Baap,1974,
359,29,14,15,0,Madhosh,1974,
360,34,9,25,0,Majboor,1974,
361,25,6,19,0,Manoranjan,1974,
362,36,14,22,0,Naya Din Nai Raat,1974,
363,32,14,18,0,Prem Nagar,1974,
364,8,4,4,0,Rajnigandha,1974,
365,23,3,20,0,Roti,1974,
366,35,8,27,0,Roti Kapada Aur Makaan,1974,
367,27,4,23,0,Sagina,1974,
368,18,2,16,0,Aandhi,1975,
369,27,6,21,0,Amanush,1975,
370,21,4,17,0,Chori Mera Kaam,1975,
371,19,4,15,0,Chorus,1975,
372,18,8,10,0,Chupke Chupke,1975,
373,31,5,26,0,Deewaar,1975,
374,27,8,19,0,Dharam Karam,1975,
375,41,9,32,0,Dharmatma,1975,
376,18,4,14,0,Do Jasoos,1975,
377,18,5,13,0,Faraar,1975,
378,15,7,8,0,Geet Gaata Chal,1975,
379,26,10,16,0,Jai Santoshi Maa,1975,
380,16,6,10,0,Julie,1975,
381,18,6,12,0,Khel Khel Mein,1975,
382,14,7,7,0,Khushboo,1975,
383,20,4,16,0,Mausam,1975,
384,17,9,8,0,Mili,1975,
385,23,5,18,0,Nishant,1975,
386,31,4,27,0,Pratiggya,1975,
387,16,5,11,0,Prem Kahani,1975,
388,34,6,28,0,Rafoo Chakkar,1975,
389,48,9,39,0,Sholay,1975,
390,18,6,12,0,Warrant,1975,
391,22,5,17,0,Zameer,1975,
392,20,4,16,0,Aadalat,1976,
393,32,5,27,0,Al-risâlah,1976,
394,26,9,17,0,Bairaag,1976,
395,23,7,16,0,Bajrangbali,1976,
396,16,6,10,0,Balika Badhu,1976,
397,33,13,20,0,Bullet,1976,
398,23,4,19,0,Charas,1976,
399,26,5,21,0,Chhoti Si Baat,1976,
400,8,3,5,0,Chitchor,1976,
401,30,6,24,0,Do Anjaane,1976,
402,29,5,24,0,Dus Numbri,1976,
403,34,4,30,0,Fakira,1976,
404,5,2,3,0,Ghashiram Kotwal,1976,
405,10,4,6,0,Ginny Aur Johny,1976,
406,22,5,17,0,Hera Pheri,1976,
407,8,5,3,0,Kabhie Kabhie,1976,
408,15,4,11,0,Kalicharan,1976,
409,17,4,13,0,Maa,1976,
410,14,4,10,0,Manthan,1976,
411,18,5,13,0,Mehbooba,1976,
412,25,12,13,0,Nagin,1976,
413,29,10,19,0,Wan Pipel,1976,
414,27,10,17,0,Aaina,1977,
415,10,5,5,0,Aashiq Hoon Baharon Ka,1977,
416,32,11,21,0,Agent Vinod,1977,
417,17,6,11,0,Alaap,1977,
418,29,9,20,0,Amar Akbar Anthony,1977,
419,18,5,13,0,Ananda Ashram,1977,
420,15,6,9,0,Apnapan,1977,
421,22,8,14,0,Bhumika,1977,
422,18,5,13,0,Chacha Bhatija,1977,
423,25,4,21,0,Chhailla Babu,1977,
424,55,7,48,0,Close Encounters of the Third Kind,1977,
425,19,5,14,0,Dharam Veer,1977,
426,27,8,19,0,Doosara Aadmi,1977,
427,53,17,36,0,Dream Girl,1977,
428,10,5,5,0,Gharaonda,1977,
429,39,13,26,0,Hum Kisise Kum Naheen,1977,
430,36,4,32,0,Immaan Dharam,1977,
431,23,6,17,0,Inkaar,1977,
432,34,9,25,0,Khoon Pasina,1977,
433,7,2,5,0,Kinara,1977,
434,21,3,18,0,Kitaab,1977,
435,11,3,8,0,Mrigayaa,1977,
436,16,6,10,0,Palkon Ki Chhaon Mein,1977,
437,25,10,15,0,Parvarish,1977,
438,25,4,21,0,Shatranj Ke Khilari,1977,
439,12,2,10,0,Shirdi Ke Sai Baba,1977,
440,12,5,7,0,Swami,1977,
441,25,7,18,0,Yehi Hai Zindagi,1977,
442,22,7,15,0,Ankhiyon Ke Jharokhon Se,1978,
443,18,6,12,0,Arvind Desai Ki Ajeeb Dastaan,1978,
444,25,5,20,0,Azaad,1978,
445,15,7,8,0,Besharam,1978,
446,26,5,21,0,Darwaza,1978,
447,28,4,24,0,Des Pardes,1978,
448,21,13,8,0,Dillagi,1978,
449,50,9,41,0,Don,1978,
450,17,6,11,0,Gaman,1978,
451,62,14,48,0,Ganga Ki Saugand,1978,
452,23,3,20,0,Ghar,1978,
453,11,4,7,0,Heeralal Pannalal,1978,
454,37,6,31,0,Kasme Vaade,1978,
455,19,6,13,0,Khatta Meetha,1978,
456,8,4,4,0,Kissaa Kursee Kaa,1978,
457,25,9,16,0,Main Tulsi Tere Aangan Ki,1978,
458,24,8,16,0,Muqaddar Ka Sikandar,1978,
459,24,12,12,0,Naukri,1978,
460,7,4,3,0,Pati Patni Aur Woh,1978,
461,24,12,12,0,Satyam Shivam Sundaram: Love Sublime,1978,
462,13,6,7,0,Shalimar,1978,
463,13,5,8,0,Trishul,1978,
464,29,5,24,0,Vishwanath,1978,
465,13,6,7,0,Alavuddinum Athbutha Vilakkum,1979,
466,10,4,6,0,Amar Deep,1979,
467,23,6,17,0,Anurodh,1979,
468,10,6,4,0,Baton Baton Mein,1979,
469,10,4,6,0,Do Ladke Dono Kadke,1979,
470,24,10,14,0,Gol Maal,1979,
471,21,4,17,0,Griha Pravesh,1979,
472,54,19,35,0,Jaani Dushman,1979,
473,15,7,8,0,Junoon,1979,
474,17,4,13,0,Jurmana,1979,
475,49,6,43,0,Kaala Patthar,1979,
476,21,7,14,0,Lahu Ke Do Rang,1979,
477,19,9,10,0,Lok Parlok,1979,
478,12,4,8,0,Manzil,1979,
479,17,4,13,0,Meera,1979,
480,8,1,7,0,Meri Biwi Ki Shaadi,1979,
481,27,6,21,0,Mr. Natwarlal,1979,
482,9,5,4,0,Nauker,1979,
483,22,5,17,0,Noorie,1979,
484,11,3,8,0,Rikki-Tikki-Tavi,1979,
485,19,7,12,0,Sargam,1979,
486,25,7,18,0,Suhaag,1979,
487,12,4,8,0,Surakksha,1979,
488,14,4,10,0,Thayillamal Nannilai,1979,
489,23,5,18,0,The Great Gambler,1979,
490,20,4,16,0,Aakrosh,1980,
491,11,2,9,0,Aap Ke Deewane,1980,
492,27,7,20,0,Aasha,1980,
493,21,8,13,0,Abdullah,1980,
494,20,5,15,0,Albert Pinto Ko Gussa Kyon Ata Hai,1980,
495,30,4,26,0,Alibaba Aur 40 Chor,1980,
496,16,6,10,0,Apne Paraye,1980,
497,9,4,5,0,Bhavni Bhavai,1980,
498,17,3,14,0,Bombay 405 Miles,1980,
499,29,6,23,0,Chann Pardesee,1980,
500,63,18,45,0,Dadar Kirti,1980,
501,25,3,22,0,Do Aur Do Paanch,1980,
502,37,5,32,0,Dostana,1980,
503,20,7,13,0,Gehrayee,1980,
504,15,4,11,0,Guru,1980,
505,34,11,23,0,Hum Paanch,1980,
506,15,3,12,0,Insaf Ka Tarazu,1980,
507,5,2,3,0,Johnny,1980,
508,33,8,25,0,Karz,1980,
509,14,6,8,0,Khubsoorat,1980,
510,17,6,11,0,Lootmaar,1980,
511,20,7,13,0,Man Pasand,1980,
512,30,10,20,0,Phir Wohi Raat,1980,
513,44,12,32,0,Qurbani,1980,
514,28,7,21,0,Ram Balram,1980,
515,29,13,16,0,Red Rose,1980,
516,29,7,22,0,Shaan,1980,
517,11,2,9,0,Sparsh,1980,
518,15,5,10,0,Swayamvar,1980,
519,40,12,28,0,The Burning Train,1980,
520,29,12,17,0,Thodisi Bewafaii,1980,
521,28,19,9,0,36 Chowringhee Lane,1981,
522,21,5,16,0,Aas Paas,1981,
523,22,5,17,0,Barsaat Ki Ek Raat,1981,
524,15,4,11,0,Baseraa,1981,
525,19,9,10,0,Biwi O Biwi,1981,
526,26,7,19,0,Bulundi,1981,
527,14,5,9,0,Chakra,1981,
528,21,6,15,0,Chashme Buddoor,1981,
529,9,3,6,0,Chettaniki Kallu Levu,1981,
530,30,6,24,0,Dhuan,1981,
531,11,5,6,0,Ek Duuje Ke Liye,1981,
532,19,11,8,0,Ek Hi Bhool,1981,
533,21,5,16,0,Hotel,1981,
534,23,8,15,0,Itni Si Baat,1981,
535,36,9,27,0,Kaalia,1981,
536,27,8,19,0,Kalyug,1981,
537,19,6,13,0,Katilon Ke Kaatil,1981,
538,41,9,32,0,Kranti,1981,
539,29,5,24,0,Krodhi,1981,
540,29,8,21,0,Kudrat,1981,
541,30,12,18,0,Laawaris,1981,
542,7,3,4,0,Love Story,1981,
543,20,6,14,0,Naram Garam,1981,
544,50,16,34,0,Naseeb,1981,
545,19,9,10,0,Prem Geet,1981,
546,29,4,25,0,Professor Pyarelal,1981,
547,6,4,2,0,Pyaasa Sawan,1981,
548,40,15,25,0,Rocky,1981,
549,11,2,9,0,Sazaye Maut,1981,
550,22,9,13,0,Silsila,1981,
551,10,3,7,0,Thee,1981,
552,27,8,19,0,Yaarana,1981,
553,28,8,20,0,Zamaane Ko Dikhana Hai,1981,
554,23,6,17,0,Angoor,1982,
555,13,6,7,0,Anokha Bandhan,1982,
556,15,9,6,0,Arth,1982,
557,24,6,18,0,Ashanti,1982,
558,13,8,5,0,Bazaar,1982,
559,22,8,14,0,Bemisal,1982,
560,33,6,27,0,Desh Premee,1982,
561,37,6,31,0,Dharam Kanta,1982,
562,25,9,16,0,Disco Dancer,1982,
563,15,4,11,0,Ghazab,1982,
564,21,3,18,0,Gopichand Jasoos,1982,
565,22,7,15,0,Hamari Bahu Alka,1982,
566,15,6,9,0,Jeevan Dhaara,1982,
567,8,3,5,0,Kaamchor,1982,
568,36,10,26,0,Khud-Daar,1982,
569,7,6,1,0,Nadiya Ke Paar,1982,
570,23,7,16,0,Namak Halaal,1982,
571,13,4,9,0,Namkeen,1982,
572,34,14,20,0,Prem Rog,1982,
573,17,4,13,0,Rajput,1982,
574,8,3,5,0,Ranga,1982,
575,17,8,9,0,Saath Saath,1982,
576,16,5,11,0,Samraat,1982,
577,31,11,20,0,Sanam Teri Kasam,1982,
578,23,9,14,0,Satte Pe Satta,1982,
579,20,2,18,0,Shakti,1982,
580,15,8,7,0,Shaukeen,1982,
581,28,14,14,0,Shriman Shrimati,1982,
582,26,9,17,0,Swami Dada,1982,
583,28,9,19,0,Teesri Aankh,1982,
584,18,11,7,0,Umbartha,1982,
585,21,6,15,0,Vakil Babu,1982,
586,12,6,6,0,Vazhve Mayam,1982,
587,27,3,24,0,Vidhaata,1982,
588,23,6,17,0,Vijeta,1982,
589,11,5,6,0,Yeh Vaada Raha,1982,
590,12,2,10,0,Adi Shankaracharya,1983,
591,18,5,13,0,Agar Tum Na Hote,1983,
592,12,3,9,0,Andhaa Kaanoon,1983,
593,37,7,30,0,Ardh Satya,1983,
594,12,5,7,0,Arpan,1983,
595,16,4,12,0,Avtaar,1983,
596,23,8,15,0,Bade Dil Wala,1983,
597,17,4,13,0,Betaab,1983,
598,20,6,14,0,Coolie,1983,
599,23,7,16,0,Hero,1983,
600,11,5,6,0,Himmatwala,1983,
601,21,2,19,0,Jaane Bhi Do Yaaro,1983,
602,13,4,9,0,Jaani Dost,1983,
603,11,3,8,0,Justice Chaudhury,1983,
604,14,5,9,0,Kalaakaar,1983,
605,14,9,5,0,Katha,1983,
606,22,7,15,0,Kissi Se Na Kehna,1983,
607,21,7,14,0,Mahaan,1983,
608,29,13,16,0,Mandi,1983,
609,17,8,9,0,Masoom,1983,
610,10,4,6,0,Mawaali,1983,
611,20,3,17,0,Mazdoor,1983,
612,42,12,30,0,Nastik,1983,
613,19,4,15,0,Naukar Biwi Ka,1983,
614,108,47,61,0,Octopussy,1983,
615,9,3,6,0,Paayum Puli,1983,
616,36,11,25,0,Pasand Apni Apni,1983,
617,41,9,32,0,Pukar,1983,
618,12,5,7,0,Rang Birangi,1983,
619,15,5,10,0,Sadma,1983,
620,17,3,14,0,Souten,1983,
621,26,7,19,0,Taqdeer,1983,
622,4,3,1,0,Thanga Magan,1983,
623,5,1,4,0,Thoongathey Tambi Thoongathey,1983,
624,11,5,6,0,Woh 7 Din,1983,
625,6,2,4,0,Zara Si Zindagi,1983,
626,32,8,24,0,A Passage to India,1984,
627,29,9,20,0,Aaj Ki Awaz,1984,
628,8,2,6,0,Ab Ayega Mazaa,1984,
629,11,5,6,0,Abodh,1984,
630,20,8,12,0,Andar Baahar,1984,
631,21,7,14,0,Baazi,1984,
632,27,7,20,0,Boxer,1984,
633,36,6,30,0,Duniya,1984,
634,7,4,3,0,Enakkul Oruvan,1984,
635,15,5,10,0,Ghar Ek Mandir,1984,
636,8,3,5,0,Hip Hip Hurray,1984,
637,18,3,15,0,Inquilaab,1984,
638,12,5,7,0,Jaag Utha Insan,1984,
639,29,7,22,0,Jagir,1984,
640,20,5,15,0,Kasam Paida Karne Wale Ki,1984,
641,4,3,1,0,Khandhar,1984,
642,25,8,17,0,Lakhon Ki Baat,1984,
643,17,4,13,0,Maqsad,1984,
644,17,2,15,0,Mashaal,1984,
645,22,4,18,0,Mohan Joshi Hazir Ho!,1984,
646,8,1,7,0,My Dear Kuttichaathan,1984,
647,35,9,26,0,Paar,1984,
648,9,6,3,0,Paroma,1984,
649,26,7,19,0,Party,1984,
650,19,8,11,0,Purana Mandir,1984,
651,5,3,2,0,Pyasa Shaitan,1984,
652,24,7,17,0,Raaj Tilak,1984,
653,23,1,22,0,Saaransh,1984,
654,27,4,23,0,Sharaabi,1984,
655,33,9,24,0,Sohni Mahiwal,1984,
656,11,3,8,0,Sunny,1984,
657,12,6,6,0,Tohfa,1984,
658,28,10,18,0,Utsav,1984,
659,21,8,13,0,Aakhir Kyon?,1985,
660,14,3,11,0,Adventures of Tarzan,1985,
661,13,3,10,0,Aghaat,1985,
662,10,3,7,0,Aitbaar,1985,
663,21,6,15,0,Alag Alag,1985,
664,9,4,5,0,Ankahee,1985,
665,32,7,25,0,Arjun,1985,
666,26,7,19,0,Awara Baap,1985,
667,4,2,2,0,Damul,1985,
668,31,7,24,0,Geraftaar,1985,
669,16,5,11,0,Ghulami,1985,
670,23,5,18,0,Holi,1985,
671,18,6,12,0,Hum Naujawan,1985,
672,20,7,13,0,Jhoothi,1985,
673,21,5,16,0,Mard,1985,
674,10,5,5,0,Masterji,1985,
675,16,6,10,0,Meri Jung,1985,
676,9,4,5,0,Mohabbat,1985,
677,4,1,3,0,Oru Kaidhiyin Diary,1985,
678,15,8,7,0,Pataal Bhairavi,1985,
679,16,7,9,0,Pyar Jhukta Nahin,1985,
680,11,8,3,0,Pyari Behna,1985,
681,31,9,22,0,Ram Teri Ganga Maili,1985,
682,13,5,8,0,Saagar,1985,
683,30,10,20,0,Saaheb,1985,
684,10,5,5,0,Sanjog,1985,
685,18,9,9,0,Tawaif,1985,
686,14,2,12,0,Teri Meherbaniyan,1985,
687,16,5,11,0,"Trikal Past, Present, Future",1985,
688,28,5,23,0,Yudh,1985,
689,30,9,21,0,Zabardast,1985,
690,28,4,24,0,Aakhree Raasta,1986,
691,25,6,19,0,Allah-Rakha,1986,
692,27,8,19,0,Amrit,1986,
693,15,4,11,0,Ankush,1986,
694,11,5,6,0,Anubhav,1986,
695,18,5,13,0,Baat Ban Jaye,1986,
696,23,9,14,0,Bhagwaan Dada,1986,
697,27,7,20,0,Chameli Ki Shaadi,1986,
698,20,8,12,0,Dharm Adhikari,1986,
699,21,8,13,0,Dilwaala,1986,
700,22,8,14,0,Ek Chadar Maili Si,1986,
701,17,7,10,0,Gandhinagar 2nd Street,1986,
702,3,1,2,0,Genesis,1986,
703,20,4,16,0,Ilzaam,1986,
704,23,6,17,0,Jaal,1986,
705,26,9,17,0,Janbaaz,1986,
706,25,9,16,0,Karma,1986,
707,15,3,12,0,Khamosh,1986,
708,6,3,3,0,Kondaveeti Raja,1986,
709,14,5,9,0,Love 86,1986,
710,39,7,32,0,Naam,1986,
711,21,8,13,0,Nagina,1986,
712,6,3,3,0,Naseeb Apna Apna,1986,
713,13,2,11,0,New Delhi Times,1986,
714,13,2,11,0,Peechha Karro,1986,
715,4,3,1,0,Punnagai Mannan,1986,
716,14,4,10,0,Qatl,1986,
717,17,4,13,0,Samundar,1986,
718,17,4,13,0,Sri Shirdi Saibaba Mahathyam,1986,
719,13,7,6,0,Swarag Se Sunder,1986,
720,14,6,8,0,Swati,1986,
721,19,5,14,0,Tahkhana,1986,
722,14,5,9,0,Vikram,1986,
723,18,2,16,0,'Kaash',1987,
724,17,4,13,0,Aag Hi Aag,1987,
725,10,2,8,0,Aaj,1987,
726,15,7,8,0,Andhaa Yudh,1987,
727,17,7,10,0,Aulad,1987,
728,18,6,12,0,Dacait,1987,
729,28,7,21,0,Dance Dance,1987,
730,22,8,14,0,Hifazat,1987,
731,31,8,23,0,Hukumat,1987,
732,11,5,6,0,Ijaazat,1987,
733,22,3,19,0,Imaandaar,1987,
734,13,2,11,0,Inaam Dus Hazaar,1987,
735,18,4,14,0,Insaaf,1987,
736,17,3,14,0,Jalwa,1987,
737,5,2,3,0,Kaadhal Parisu,1987,
738,33,7,26,0,Khudgarz,1987,
739,25,2,23,0,Loha,1987,
740,35,7,28,0,Marte Dam Tak,1987,
741,6,2,4,0,Massey Sahib,1987,
742,14,6,8,0,Mirch Masala,1987,
743,9,2,7,0,Mohre,1987,
744,24,4,20,0,Mr. India,1987,
745,8,2,6,0,Nayakan,1987,
746,20,7,13,0,Nazrana,1987,
747,13,2,11,0,New Delhi,1987,
748,27,7,20,0,Pratighaat,1987,
749,14,6,8,0,Sansar,1987,
750,28,5,23,0,Satyamev Jayate,1987,
751,11,3,8,0,Sindoor,1987,
752,18,7,11,0,Superman,1987,
753,13,7,6,0,Uttar Dakshin,1987,
754,19,7,12,0,Watan Ke Rakhwale,1987,
755,23,5,18,0,Aakhri Adaalat,1988,
756,11,5,6,0,Aryan,1988,
757,14,4,10,0,Bees Saal Baad,1988,
758,17,6,11,0,Biwi Ho To Aisi,1988,
759,30,4,26,0,Commando,1988,
760,13,5,8,0,Daisy,1988,
761,23,7,16,0,Dariya Dil,1988,
762,17,5,12,0,Dayavan,1988,
763,22,5,17,0,Gangaa Jamunaa Saraswathi,1988,
764,13,8,5,0,Ghar Ghar Ki Kahani,1988,
765,24,8,16,0,Hatya,1988,
766,20,2,18,0,Hero Hiralal,1988,
767,14,5,9,0,Inteqam,1988,
768,26,4,22,0,Jeete Hain Shaan Se,1988,
769,30,5,25,0,Kabzaa,1988,
770,38,12,26,0,Khatron Ke Khiladi,1988,
771,22,8,14,0,Khoon Bhari Maang,1988,
772,27,5,22,0,Maalamaal,1988,
773,6,2,4,0,Om Dar-B-Dar,1988,
774,10,3,7,0,Paap Ki Duniya,1988,
775,7,3,4,0,Pestonjee,1988,
776,23,7,16,0,Pyar Ka Mandir,1988,
777,31,10,21,0,Qayamat Se Qayamat Tak,1988,
778,22,4,18,0,Ram-Avtar,1988,
779,37,17,20,0,Rihaee,1988,
780,45,9,36,0,Salaam Bombay!,1988,
781,43,8,35,0,Shahenshah,1988,
782,25,7,18,0,Sone Pe Suhaaga,1988,
783,32,8,24,0,Tezaab,1988,
784,26,4,22,0,The Deceivers,1988,
785,9,3,6,0,Vaishali,1988,
786,25,8,17,0,Veerana,1988,
787,15,6,9,0,Vijay,1988,
788,29,12,17,0,Waaris,1988,
789,14,5,9,0,Waqt Ki Awaz,1988,
790,10,5,5,0,Yateem,1988,
791,20,6,14,0,Zalzala,1988,
792,13,4,9,0,Apoorva Sagodharargal,1989,
793,4,2,2,0,Bagh Bahadur,1989,
794,11,7,4,0,Bahurani,1989,
795,13,5,8,0,Batwara,1989,
796,27,9,18,0,Bhrashtachar,1989,
797,11,3,8,0,Chaalbaaz,1989,
798,19,11,8,0,Chandni,1989,
799,24,7,17,0,Clerk,1989,
800,20,7,13,0,Do Qaidi,1989,
801,29,12,17,0,Eeshwar,1989,
802,8,4,4,0,Ek Din Achanak,1989,
803,28,5,23,0,Elaan-E-Jung,1989,
804,30,13,17,0,Gair Kaanooni,1989,
805,10,3,7,0,Ghar Ka Chiraag,1989,
806,17,6,11,0,Gharana,1989,
807,28,5,23,0,Guru,1989,
808,9,4,5,0,Hathyar,1989,
809,34,5,29,0,Ilaaka,1989,
810,7,3,4,0,Indrudu Chandrudu,1989,
811,23,4,19,0,Jaadugar,1989,
812,22,5,17,0,Jaisi Karni Waisi Bharni,1989,
813,29,5,24,0,Joshilaay,1989,
814,16,4,12,0,Kala Bazaar,1989,
815,16,10,6,0,Kamla Ki Maut,1989,
816,16,7,9,0,Kanoon Apna Apna,1989,
817,9,5,4,0,Khoj,1989,
818,19,4,15,0,Love Love Love,1989,
819,21,2,19,0,Main Azaad Hoon,1989,
820,27,5,22,0,Maine Pyar Kiya,1989,
821,19,8,11,0,Marhi Da Deeva,1989,
822,43,12,31,0,Mujrim,1989,
823,23,10,13,0,Nigahen: Nagina Part II,1989,
824,32,2,30,0,Parinda,1989,
825,19,6,13,0,Prem Pratigyaa,1989,
826,29,12,17,0,Purani Haveli,1989,
827,4,2,2,0,Raakh,1989,
828,16,6,10,0,Rakhwala,1989,
829,21,5,16,0,Ram Lakhan,1989,
830,7,2,5,0,Rudranetra,1989,
831,20,3,17,0,Salim Langde Pe Mat Ro,1989,
832,37,7,30,0,Shiva,1989,
833,9,5,4,0,State Rowdy,1989,
834,10,3,7,0,Taaqatwar,1989,
835,35,6,29,0,Toofan,1989,
836,41,9,32,0,Tridev,1989,
837,19,6,13,0,Vardi,1989,
838,7,3,4,0,Vetri Vizha,1989,
839,24,3,21,0,Aag Ka Gola,1990,
840,15,4,11,0,Aaj Ka Arjun,1990,
841,14,3,11,0,Aashiqui,1990,
842,18,6,12,0,Adisaya Piravi,1990,
843,29,9,20,0,Agneepath,1990,
844,9,4,5,0,Anjali,1990,
845,18,3,15,0,Awaargi,1990,
846,25,4,21,0,Awwal Number,1990,
847,28,7,21,0,Baaghi: A Rebel for Love,1990,
848,20,4,16,0,Baap Numbri Beta Dus Numbri,1990,
849,17,8,9,0,Bandh Darwaza,1990,
850,16,3,13,0,C.I.D.,1990,
851,14,5,9,0,Deewana Mujh Sa Nahin,1990,
852,27,6,21,0,Dil,1990,
853,22,4,18,0,Disha,1990,
854,26,7,19,0,Doodh Ka Karz,1990,
855,22,11,11,0,Drishti,1990,
856,38,5,33,0,Ek Doctor Ki Maut,1990,
857,20,8,12,0,Ghar Ho To Aisa,1990,
858,30,8,22,0,Ghayal,1990,
859,16,4,12,0,Haatim Tai,1990,
860,20,7,13,0,Izzatdaar,1990,
861,11,4,7,0,Jamai Raja,1990,
862,22,8,14,0,Jawani Zindabad,1990,
863,20,5,15,0,Jeevan Ek Sanghursh,1990,
864,17,5,12,0,Jurm,1990,
865,30,4,26,0,Khatarnaak,1990,
866,18,4,14,0,Kishen Kanhaiya,1990,
867,27,6,21,0,Kroadh,1990,
868,11,4,7,0,Lekin...,1990,
869,21,4,17,0,Maha-Sangram,1990,
870,12,5,7,0,Michael Madana Kamarajan,1990,
871,21,7,14,0,Police Public,1990,
872,10,3,7,0,Pratibandh,1990,
873,21,10,11,0,Pyar Ka Devta,1990,
874,30,8,22,0,Sailaab,1990,
875,9,3,6,0,Sheshnaag,1990,
876,28,7,21,0,Swarg,1990,
877,36,9,27,0,Thanedaar,1990,
878,16,3,13,0,Thodasa Roomani Ho Jaayen,1990,
879,27,12,15,0,Tum Mere Ho,1990,
880,15,6,9,0,Zahreelay,1990,
881,15,4,11,0,100 Days,1991,
882,8,3,5,0,Abhimanyu,1991,
883,19,10,9,0,Afsana Pyar Ka,1991,
884,26,5,21,0,Ajooba,1991,
885,25,8,17,0,Akayla,1991,
886,7,2,5,0,Antarnaad,1991,
887,18,5,13,0,Banjaran,1991,
888,16,4,12,0,Benaam Badsha,1991,
889,13,6,7,0,Bhabhi,1991,
890,5,2,3,0,Captain Prabhakaran,1991,
891,16,3,13,0,Dancer,1991,
892,7,2,5,0,Diksha,1991,
893,20,4,16,0,Dil Hai Ki Manta Nahin,1991,
894,50,7,43,0,Farishtay,1991,
895,25,10,15,0,Henna,1991,
896,18,8,10,0,Hum,1991,
897,18,5,13,0,Indrajeet,1991,
898,24,7,17,0,Inspector Balram,1991,
899,17,5,12,0,Karz Chukana Hai,1991,
900,17,10,7,0,Khilaaf,1991,
901,24,7,17,0,Khoon Ka Karz,1991,
902,16,5,11,0,Kurbaan,1991,
903,10,5,5,0,Lamhe,1991,
904,8,3,5,0,Love,1991,
905,28,6,22,0,Narasimha,1991,
906,14,2,12,0,Patthar Ke Phool,1991,
907,33,8,25,0,Phool Aur Kaante,1991,
908,12,4,8,0,Phool Bane Angaarey,1991,
909,11,2,9,0,Prahaar: The Final Attack,1991,
910,29,9,20,0,Pratikar,1991,
911,6,2,4,0,Prem Qaidi,1991,
912,19,7,12,0,Saajan,1991,
913,22,1,21,0,Saathi,1991,
914,16,1,15,0,Sadak,1991,
915,16,4,12,0,Sanam Bewafa,1991,
916,23,7,16,0,Saudagar,1991,
917,23,8,15,0,Saugandh,1991,
918,7,3,4,0,Shanti Kranti,1991,
919,18,7,11,0,Stoovertpuram Police Station,1991,
920,28,4,24,0,Trinetra,1991,
921,15,4,11,0,Yodha,1991,
922,19,6,13,0,Aaj Ka Goonda Raaj,1992,
923,16,2,14,0,Adharm,1992,
924,24,5,19,0,Angaar,1992,
925,9,2,7,0,Ashwamedham,1992,
926,19,6,13,0,Balwaan,1992,
927,14,4,10,0,Bekhudi,1992,
928,32,8,24,0,Beta,1992,
929,11,4,7,0,Bewaffa Se Waffa,1992,
930,25,4,21,0,Bol Radha Bol,1992,
931,33,8,25,0,Chamatkar,1992,
932,3,2,1,0,Cheluvi,1992,
933,12,4,8,0,Daulat Ki Jung,1992,
934,38,11,27,0,Deedar,1992,
935,22,10,12,0,Deewana,1992,
936,14,3,11,0,Dharavi,1992,
937,22,9,13,0,Dil Aashna Hai ...The Heart Knows,1992,
938,9,3,6,0,Dil Hi To Hai,1992,
939,18,4,14,0,Dil Ka Kya Kasoor,1992,
940,12,4,8,0,Drohi,1992,
941,18,5,13,0,Ek Hota Vidushak,1992,
942,14,2,12,0,Ek Ladka Ek Ladki,1992,
943,38,14,24,0,Heer Ranjha,1992,
944,14,4,10,0,Isi Ka Naam Zindagi,1992,
945,21,5,16,0,Jaan Se Pyaara,1992,
946,15,7,8,0,Jaan Tere Naam,1992,
947,23,6,17,0,Jigar,1992,
948,23,7,16,0,Jo Jeeta Wohi Sikandar,1992,
949,11,2,9,0,Junoon,1992,
950,19,4,15,0,Khel,1992,
951,28,5,23,0,Khiladi,1992,
952,19,6,13,0,Khuda Gawah,1992,
953,13,6,7,0,Killer,1992,
954,16,5,11,0,Maa,1992,
955,18,7,11,0,Mr. Bond,1992,
956,15,6,9,0,Muskurahat,1992,
957,23,8,15,0,Nishchaiy,1992,
958,17,3,14,0,Prem Deewane,1992,
959,14,4,10,0,Raat,1992,
960,11,3,8,0,Radha Ka Sangam,1992,
961,30,3,27,0,Raju Ban Gaya Gentleman,1992,
962,9,5,4,0,Roja,1992,
963,4,1,3,0,Rowdy Inspector,1992,
964,16,6,10,0,Saatwan Aasman,1992,
965,15,4,11,0,Sahebzaade,1992,
966,9,3,6,0,Sangeet,1992,
967,12,5,7,0,Sapne Saajan Ke,1992,
968,17,5,12,0,Shola Aur Shabnam,1992,
969,24,11,13,0,Suraj Ka Satvan Ghoda,1992,
970,19,4,15,0,Suryavanshi,1992,
971,31,6,25,0,Tahalka,1992,
972,24,5,19,0,Tirangaa,1992,
973,27,10,17,0,Vansh,1992,
974,19,4,15,0,Virodhi,1992,
975,44,8,36,0,Vishwatma,1992,
976,9,4,5,0,Yaad Rakhegi Duniya,1992,
977,17,6,11,0,Yalgaar,1992,
978,29,8,21,0,Zindagi Ek Juaa,1992,
979,23,7,16,0,Zulm Ki Hukumat,1992,
980,25,5,20,0,Aadmi,1993,
981,10,4,6,0,Aadmi Khilona Hai,1993,
982,10,4,6,0,Aaina,1993,
983,33,8,25,0,Aankhen,1993,
984,18,5,13,0,Aashik Aawara,1993,
985,19,10,9,0,Aasoo Bane Angaarey,1993,
986,7,2,5,0,Anari,1993,
987,15,5,10,0,Anmol,1993,
988,8,2,6,0,Ashaant,1993,
989,28,8,20,0,Baazigar,1993,
990,23,6,17,0,Bedardi,1993,
991,15,5,10,0,Chandra Mukhi,1993,
992,30,4,26,0,Dalaal,1993,
993,20,6,14,0,Damini,1993,
994,9,4,5,0,Darr,1993,
995,11,4,7,0,Dhanwaan,1993,
996,10,3,7,0,Dil Hai Betaab,1993,
997,28,6,22,0,Dil Ki Baazi,1993,
998,27,8,19,0,Dil Tera Aashiq,1993,
999,26,7,19,0,Divya Shakti,1993,
1000,9,1,8,0,Ek Hi Raasta,1993,
1001,15,4,11,0,Gardish,1993,
1002,13,5,8,0,Govindha Govindha,1993,
1003,19,6,13,0,Gumrah,1993,
1004,12,4,8,0,Gunaah,1993,
1005,21,3,18,0,Gurudev,1993,
1006,30,7,23,0,Hum Hain Kamaal Ke,1993,
1007,20,5,15,0,Hum Hain Rahi Pyar Ke,1993,
1008,14,6,8,0,Izzat Ki Roti,1993,
1009,32,3,29,0,Jaagruti,1993,
1010,5,3,2,0,Kalaignan,1993,
1011,9,2,7,0,Karamati Coat,1993,
1012,20,4,16,0,Kayda Kanoon,1993,
1013,39,6,33,0,Khal Nayak,1993,
1014,6,4,2,0,Khal-Naaikaa,1993,
1015,27,8,19,0,King Uncle,1993,
1016,12,5,7,0,Kshatriya,1993,
1017,13,2,11,0,Lootere,1993,
1018,14,6,8,0,Mahakaal,1993,
1019,16,2,14,0,Maya,1993,
1020,11,3,8,0,Muqabla,1993,
1021,10,3,7,0,Mutamestri,1993,
1022,12,5,7,0,Parampara,1993,
1023,21,3,18,0,Pehchaan,1993,
1024,26,4,22,0,Pehla Nasha,1993,
1025,14,3,11,0,Phir Teri Kahani Yaad Aayee,1993,
1026,16,7,9,0,Phool,1993,
1027,32,3,29,0,Phool Aur Angaar,1993,
1028,17,5,12,0,Platform,1993,
1029,18,8,10,0,Rang,1993,
1030,35,8,27,0,Roop Ki Rani Choron Ka Raja,1993,
1031,17,6,11,0,Rudaali,1993,
1032,25,10,15,0,Sahibaan,1993,
1033,25,4,21,0,Sainik,1993,
1034,13,4,9,0,Sangram,1993,
1035,21,8,13,0,Sardar,1993,
1036,11,3,8,0,Shaktiman,1993,
1037,26,7,19,0,Shatranj,1993,
1038,7,3,4,0,Shreemaan Aashique,1993,
1039,21,3,18,0,Sir,1993,
1040,10,2,8,0,Tadipaar,1993,
1041,23,5,18,0,Waqt Hamara Hai,1993,
1042,13,3,10,0,Zapatlela,1993,
1043,30,4,26,0,1942: A Love Story,1994,
1044,15,3,12,0,Aa Gale Lag Jaa,1994,
1045,17,4,13,0,Aag,1994,
1046,15,5,10,0,Aao Pyaar Karen,1994,
1047,22,3,19,0,Aatish: Feel the Fire,1994,
1048,28,6,22,0,Amaanat,1994,
1049,19,4,15,0,Andaz,1994,
1050,16,3,13,0,Andaz Apna Apna,1994,
1051,15,6,9,0,Anjaam,1994,
1052,12,4,8,0,Anth,1994,
1053,58,9,49,0,Bandit Queen,1994,
1054,16,6,10,0,Bhairava Dweepam,1994,
1055,17,7,10,0,Chaand Kaa Tukdaa,1994,
1056,20,7,13,0,Cheetah,1994,
1057,13,5,8,0,Chung Hing sam lam,1994,
1058,29,5,24,0,Dilwale,1994,
1059,23,4,19,0,Droh Kaal,1994,
1060,8,1,7,0,Duet,1994,
1061,39,10,29,0,Dulaara,1994,
1062,34,8,26,0,Eena Meena Deeka,1994,
1063,31,3,28,0,Ekka Raja Rani,1994,
1064,13,3,10,0,Elaan,1994,
1065,14,4,10,0,Gopi Kishan,1994,
1066,35,14,21,0,Hum Aapke Hain Koun...!,1994,
1067,21,3,18,0,Hum Hain Bemisaal,1994,
1068,25,7,18,0,Ikke Pe Ikka,1994,
1069,13,3,10,0,Imtihaan,1994,
1070,59,14,45,0,In Custody,1994,
1071,23,7,16,0,Insaniyat,1994,
1072,11,3,8,0,Jai Kishen,1994,
1073,22,8,14,0,Kabhi Haan Kabhi Naa,1994,
1074,14,3,11,0,Kanoon,1994,
1075,13,3,10,0,Khuddar,1994,
1076,35,7,28,0,Krantiveer,1994,
1077,18,6,12,0,Laadla,1994,
1078,14,4,10,0,Madam X,1994,
1079,6,2,4,0,Madhosh,1994,
1080,23,6,17,0,Main Khiladi Tu Anari,1994,
1081,19,6,13,0,Mammo,1994,
1082,40,8,32,0,Mohra,1994,
1083,25,5,20,0,Mr. Azaad,1994,
1084,20,5,15,0,Naaraaz,1994,
1085,16,5,11,0,Pehla Pehla Pyar,1994,
1086,14,3,11,0,Prem Shakti,1994,
1087,17,8,9,0,Professor Ki Padosan,1994,
1088,17,4,13,0,Raja Babu,1994,
1089,12,6,6,0,Saajan Ka Ghar,1994,
1090,20,4,16,0,Sangdil Sanam,1994,
1091,18,4,14,0,Suhaag,1994,
1092,20,7,13,0,Teesra Kaun?,1994,
1093,11,4,7,0,Tejasvini,1994,
1094,6,2,4,0,The Gentleman,1994,
1095,20,9,11,0,Udhaar Ki Zindagi,1994,
1096,11,4,7,0,Vijaypath,1994,
1097,10,5,5,0,Vivekananda,1994,
1098,10,4,6,0,Yaar Gaddar,1994,
1099,27,12,15,0,Yeh Dillagi,1994,
1100,27,8,19,0,Zaalim,1994,
1101,29,11,18,0,Zakhmi Dil,1994,
1102,15,4,11,0,Zamane Se Kya Darna,1994,
1103,32,7,25,0,Aatank Hi Aatank,1995,
1104,23,7,16,0,Akele Hum Akele Tum,1995,
1105,18,4,14,0,Andolan,1995,
1106,8,1,7,0,Angrakshak,1995,
1107,19,4,15,0,Baasha,1995,
1108,15,4,11,0,Baazi,1995,
1109,38,5,33,0,Barsaat,1995,
1110,34,9,25,0,Bewafa Sanam,1995,
1111,25,11,14,0,Bombay,1995,
1112,19,5,14,0,Coolie No. 1,1995,
1113,26,7,19,0,Criminal,1995,
1114,22,13,9,0,Dilwale Dulhania Le Jayenge,1995,
1115,25,8,17,0,Dushmani: A Violent Love Story,1995,
1116,19,5,14,0,Gaddaar,1995,
1117,13,2,11,0,Gambler,1995,
1118,25,5,20,0,Ghatotkachudu,1995,
1119,19,5,14,0,Guddu,1995,
1120,16,7,9,0,Gundaraj,1995,
1121,12,4,8,0,Haathkadi,1995,
1122,16,4,12,0,Haqeeqat,1995,
1123,20,3,17,0,Hulchul,1995,
1124,18,2,16,0,Hum Dono,1995,
1125,27,9,18,0,Jai Vikraanta,1995,
1126,16,6,10,0,Jallaad,1995,
1127,25,4,21,0,Karan Arjun,1995,
1128,13,3,10,0,Khilona Bana Khalnayak,1995,
1129,13,5,8,0,Maanthrikam,1995,
1130,15,4,11,0,Maidan-E-Jung,1995,
1131,14,6,8,0,Mera Damad,1995,
1132,10,2,8,0,Milan,1995,
1133,13,5,8,0,Muthu,1995,
1134,20,6,14,0,Naajayaz,1995,
1135,4,2,2,0,Naseem,1995,
1136,16,3,13,0,Nazar Ke Samne,1995,
1137,32,6,26,0,Oh Darling Yeh Hai India,1995,
1138,14,3,11,0,Paandav,1995,
1139,35,8,27,0,Prem,1995,
1140,11,3,8,0,Raasaiyya,1995,
1141,27,5,22,0,Raghuveer,1995,
1142,24,6,18,0,Raja,1995,
1143,33,4,29,0,Ram Jaane,1995,
1144,19,4,15,0,Ram Shastra,1995,
1145,16,4,12,0,Rangeela,1995,
1146,14,2,12,0,Ravan Raaj: A True Story,1995,
1147,18,3,15,0,Sabse Bada Khiladi,1995,
1148,10,3,7,0,Surakshaa,1995,
1149,27,4,23,0,Taaqat,1995,
1150,14,4,10,0,Takkar,1995,
1151,23,9,14,0,Taqdeerwala,1995,
1152,6,1,5,0,Target,1995,
1153,20,9,11,0,Tarpan The Absolution,1995,
1154,13,3,10,0,The Don,1995,
1155,13,4,9,0,Trimurti,1995,
1156,29,8,21,0,Veergati,1995,
1157,14,4,10,0,Yaraana,1995,
1158,11,4,7,0,Zamaana Deewana,1995,
1159,18,4,14,0,Aatank,1996,
1160,12,3,9,0,Agni Sakshi,1996,
1161,22,7,15,0,Ajay,1996,
1162,29,8,21,0,Army,1996,
1163,20,9,11,0,Bal Bramhachari,1996,
1164,23,6,17,0,Bambai Ka Babu,1996,
1165,20,7,13,0,Beavis and Butt-Head Do America,1996,
1166,27,5,22,0,Chaahat,1996,
1167,30,5,25,0,Chhote Sarkar,1996,
1168,21,9,12,0,Daayraa,1996,
1169,35,9,26,0,Daraar,1996,
1170,11,2,9,0,Dastak,1996,
1171,13,2,11,0,Dil Tera Diwana,1996,
1172,12,4,8,0,Diljale,1996,
1173,18,5,13,0,Dushman Duniya Ka,1996,
1174,24,5,19,0,Ek Tha Raja,1996,
1175,12,4,8,0,Fareb,1996,
1176,20,8,12,0,Fire,1996,
1177,40,7,33,0,Ghatak: Lethal,1996,
1178,3,1,2,0,Halo,1996,
1179,12,3,9,0,Himmat,1996,
1180,14,7,7,0,Indian,1996,
1181,6,2,4,0,Indira Priyanka,1996,
1182,8,2,6,0,Is Raat Ki Subah Nahin,1996,
1183,22,7,15,0,Jaan,1996,
1184,20,3,17,0,Jeet,1996,
1185,9,4,5,0,Jung,1996,
1186,6,2,4,0,Kadhal Desam,1996,
1187,19,2,17,0,Kala Pani,1996,
1188,5,1,4,0,Kalloori Vaasal,1996,
1189,16,6,10,0,Khamoshi: The Musical,1996,
1190,19,6,13,0,Khiladiyon Ka Khiladi,1996,
1191,32,6,26,0,Krishna,1996,
1192,29,5,24,0,Loafer,1996,
1193,25,3,22,0,Maachis,1996,
1194,10,3,7,0,Masoom,1996,
1195,17,9,8,0,Mr. Bechara,1996,
1196,5,2,3,0,Mr. Romeo,1996,
1197,16,5,11,0,Ninne Pelladatha,1996,
1198,10,3,7,0,Papa Kahte Hain,1996,
1199,15,4,11,0,Papi Gudia,1996,
1200,19,9,10,0,Playback,1996,
1201,25,11,14,0,PremGranth,1996,
1202,1,1,0,0,Raja Aur Rangeeli,1996,
1203,15,6,9,0,Raja Hindustani,1996,
1204,18,6,12,0,Rajkumar,1996,
1205,15,4,11,0,Rakshak,1996,
1206,28,6,22,0,Return of Jewel Thief,1996,
1207,25,6,19,0,Saajan Chale Sasural,1996,
1208,4,2,2,0,Sahasa Veerudu Sagara Kanya,1996,
1209,11,3,8,0,Sanshodhan,1996,
1210,16,4,12,0,Sapoot,1996,
1211,22,7,15,0,Sardari Begum,1996,
1212,27,7,20,0,Shastra,1996,
1213,27,4,23,0,Tere Mere Sapne,1996,
1214,22,1,21,0,The Ghost and the Darkness,1996,
1215,15,4,11,0,Tu Chor Main Sipahi,1996,
1216,23,3,20,0,Vijeta,1996,
1217,12,1,11,0,Vishwasghaat,1996,
1218,14,3,11,0,Yeh Majhdhaar,1996,
1219,13,9,4,0,...Aur Pyaar Ho Gaya,1997,
1220,18,1,17,0,Aar Ya Paar,1997,
1221,22,10,12,0,Aastha: In the Prison of Spring,1997,
1222,19,6,13,0,Aflatoon,1997,
1223,21,4,17,0,Auzaar,1997,
1224,6,2,4,0,Banarasi Babu,1997,
1225,25,6,19,0,Betaabi,1997,
1226,16,3,13,0,Bhai,1997,
1227,27,4,23,0,Border,1997,
1228,20,8,12,0,Chachi 420,1997,
1229,14,3,11,0,Daava,1997,
1230,6,4,2,0,Dance of the Wind,1997,
1231,15,2,13,0,Daud: Fun on the Run,1997,
1232,21,7,14,0,Deewana Mastana,1997,
1233,19,4,15,0,Dhaal: The Battle of Law Against Law,1997,
1234,15,8,7,0,Dil To Pagal Hai,1997,
1235,22,5,17,0,Ghulam-E-Musthafa,1997,
1236,11,5,6,0,Gudgudee,1997,
1237,37,6,31,0,Gupt: The Hidden Truth,1997,
1238,12,2,10,0,Hameshaa,1997,
1239,18,4,14,0,Hero No. 1,1997,
1240,9,3,6,0,Himalay Putra,1997,
1241,15,2,13,0,Insaaf: The Final Justice,1997,
1242,34,4,30,0,Ishq,1997,
1243,15,5,10,0,Itihaas,1997,
1244,19,7,12,0,Judaai,1997,
1245,26,6,20,0,Judwaa,1997,
1246,12,2,10,0,Kaun Sachcha Kaun Jhootha,1997,
1247,25,5,20,0,Koyla,1997,
1248,22,6,16,0,Lahoo Ke Do Rang,1997,
1249,30,11,19,0,Lal Darja,1997,
1250,27,8,19,0,Loha,1997,
1251,3,2,1,0,Love Birds,1997,
1252,21,3,18,0,Mahaanta: The Film,1997,
1253,33,8,25,0,Mohabbat,1997,
1254,24,5,19,0,Mr. & Mrs. Khiladi,1997,
1255,41,9,32,0,Mrityudaata,1997,
1256,16,3,13,0,Naseeb,1997,
1257,39,15,24,0,Once We Were Strangers,1997,
1258,23,10,13,0,Pardes,1997,
1259,24,7,17,0,Prithvi,1997,
1260,17,6,11,0,Qahar,1997,
1261,17,5,12,0,Raja Ki Ayegi Baraat,1997,
1262,2,1,1,0,Rui Ka Bojh,1997,
1263,6,4,2,0,Saaz,1997,
1264,26,4,22,0,Sanam,1997,
1265,43,3,40,0,Seven Years in Tibet,1997,
1266,20,5,15,0,Shapath,1997,
1267,17,4,13,0,Tarazu,1997,
1268,35,8,27,0,The Death Sentence: Mrityu Dand,1997,
1269,14,3,11,0,Udaan,1997,
1270,11,4,7,0,Virasat,1997,
1271,15,4,11,0,Yes Boss,1997,
1272,55,12,43,0,Yeshwant,1997,
1273,26,7,19,0,Ziddi,1997,
1274,18,5,13,0,2001: Do Hazaar Ek,1998,
1275,15,3,12,0,Aakrosh: Cyclone of Anger,1998,
1276,12,4,8,0,Aavida Maa Aavide,1998,
1277,19,5,14,0,Achanak,1998,
1278,20,3,17,0,Angaaray,1998,
1279,33,8,25,0,Aunty No. 1,1998,
1280,30,5,25,0,Bade Miyan Chote Miyan,1998,
1281,21,5,16,0,Bandhan,1998,
1282,21,4,17,0,Barood,1998,
1283,48,5,43,0,Bombay Boys,1998,
1284,6,1,5,0,Chhota Chetan,1998,
1285,42,10,32,0,China Gate,1998,
1286,11,7,4,0,Dahan,1998,
1287,36,15,21,0,Dil Se..,1998,
1288,12,3,9,0,Doli Saja Ke Rakhna,1998,
1289,19,3,16,0,Dulhe Raja,1998,
1290,19,6,13,0,Duplicate,1998,
1291,25,10,15,0,Dushman,1998,
1292,44,11,33,0,Earth,1998,
1293,22,6,16,0,Gharwali Baharwali,1998,
1294,39,3,36,0,Ghulam,1998,
1295,17,2,15,0,Gunda,1998,
1296,32,10,22,0,Hazaar Chaurasi Ki Maa,1998,
1297,8,1,7,0,Hero Hindustani,1998,
1298,22,4,18,0,Humse Badhkar Kaun: The Entertainer,1998,
1299,4,2,2,0,Hyderabad Blues,1998,
1300,13,4,9,0,Jab Pyaar Kisise Hota Hai,1998,
1301,9,3,6,0,Jhooth Bole Kauwa Kaate,1998,
1302,12,4,8,0,Kabhi Na Kabhi,1998,
1303,28,5,23,0,Kareeb,1998,
1304,22,5,17,0,Keemat: They Are Back,1998,
1305,11,7,4,0,Kuch Kuch Hota Hai,1998,
1306,21,4,17,0,Kudrat,1998,
1307,35,11,24,0,Maharaja,1998,
1308,18,3,15,0,Major Saab,1998,
1309,29,10,19,0,Mehndi,1998,
1310,3,1,2,0,Military Officer,1998,
1311,16,4,12,0,Pardesi Babu,1998,
1312,18,8,10,0,Prem Aggan,1998,
1313,15,4,11,0,Premante Idera,1998,
1314,17,3,14,0,Pyaar Kiya To Darna Kya,1998,
1315,34,8,26,0,Pyaar To Hona Hi Tha,1998,
1316,12,5,7,0,Qila,1998,
1317,7,5,2,0,Saat Rang Ke Sapne,1998,
1318,12,3,9,0,Salaakhen,1998,
1319,20,4,16,0,Sar Utha Ke Jiyo,1998,
1320,32,4,28,0,Satya,1998,
1321,28,6,22,0,Soldier,1998,
1322,20,7,13,0,Tamanna,1998,
1323,34,5,29,0,Train to Pakistan,1998,
1324,19,3,16,0,Vinashak - Destroyer,1998,
1325,17,4,13,0,Wajood,1998,
1326,15,3,12,0,Yugpurush: A Man Who Comes Just Once in a Way,1998,
1327,17,3,14,0,Zakhm,1998,
1328,26,7,19,0,Zor: Never Underestimate the Force,1998,
1329,48,21,27,0,Aa Ab Laut Chalen,1999,
1330,20,7,13,0,Aarzoo,1999,
1331,19,6,13,0,Anari No. 1,1999,
1332,10,3,7,0,Arjun Pandit,1999,
1333,35,9,26,0,Baadshah,1999,
1334,19,6,13,0,Bade Dilwala,1999,
1335,9,5,4,0,Bhopal Express,1999,
1336,11,11,0,0,Bindhaast,1999,
1337,15,6,9,0,Biwi No. 1,1999,
1338,19,6,13,0,Daag: The Fire,1999,
1339,17,6,11,0,Dahek: A Burning Passion,1999,
1340,31,13,18,0,Dil Kya Kare,1999,
1341,14,7,7,0,Dillagi,1999,
1342,17,4,13,0,Gair,1999,
1343,49,8,41,0,Godmother,1999,
1344,17,5,12,0,Haseena Maan Jaayegi,1999,
1345,12,1,11,0,Hello Brother,1999,
1346,15,5,10,0,Hogi Pyaar Ki Jeet,1999,
1347,27,7,20,0,Hote Hote Pyar Hogaya,1999,
1348,33,8,25,0,Hu Tu Tu,1999,
1349,13,5,8,0,Hum Aapke Dil Mein Rehte Hain,1999,
1350,33,14,19,0,Hum Dil De Chuke Sanam,1999,
1351,44,17,27,0,Hum Saath-Saath Hain: We Stand United,1999,
1352,12,5,7,0,Hum Tum Pe Marte Hain,1999,
1353,27,3,24,0,International Khiladi,1999,
1354,21,9,12,0,Jaanam Samjha Karo,1999,
1355,17,4,13,0,Jaanwar,1999,
1356,4,3,1,0,Jodi,1999,
1357,13,4,9,0,Kachche Dhaage,1999,
1358,11,4,7,0,Kadhalar Dinam,1999,
1359,12,5,7,0,Kairee,1999,
1360,18,6,12,0,Kartoos,1999,
1361,3,1,2,0,Kaun?,1999,
1362,22,9,13,0,Khoobsurat,1999,
1363,11,3,8,0,Kohram,1999,
1364,28,5,23,0,Laawaris,1999,
1365,24,6,18,0,Lal Baadshah,1999,
1366,36,17,19,0,Mann,1999,
1367,15,5,10,0,Mast,1999,
1368,4,2,2,0,Periyanna,1999,
1369,56,5,51,0,Phörpa,1999,
1370,29,10,19,0,Pyaar Koi Khel Nahin,1999,
1371,24,7,17,0,Pyaar Mein Kabhi Kabhi...,1999,
1372,27,6,21,0,Rajaji,1999,
1373,13,4,9,0,Ravoyi Chandamama,1999,
1374,5,2,3,0,Rockford,1999,
1375,19,5,14,0,Safari,1999,
1376,18,5,13,0,Samarasimha Reddy,1999,
1377,15,5,10,0,Samudram,1999,
1378,21,3,18,0,Sangharsh,1999,
1379,23,10,13,0,Sar Ankhon Par,1999,
1380,48,11,37,0,Sarfarosh,1999,
1381,10,3,7,0,Shool,1999,
1382,16,8,8,0,Silsila Hai Pyar Ka,1999,
1383,13,5,8,0,Sirf Tum,1999,
1384,12,4,8,0,Sneham Kosam,1999,
1385,18,7,11,0,Sooryavansham,1999,
1386,115,35,80,0,Split Wide Open,1999,
1387,36,11,25,0,Taal,1999,
1388,21,5,16,0,Tales of the KamaSutra 2: Monsoon,1999,
1389,28,8,20,0,Thakshak,1999,
1390,13,2,11,0,Thammudu,1999,
1391,7,2,5,0,Vaalee,1999,
1392,53,10,43,0,Vaastav: The Reality,1999,
1393,13,5,8,0,Yeh Hai Mumbai Meri Jaan,1999,
1394,18,4,14,0,Zulmi,1999,
1395,24,6,18,0,Aaghaaz,2000,
1396,11,5,6,0,Astitva,2000,
1397,20,6,14,0,Azaad,2000,
1398,36,8,28,0,Baaghi,2000,
1399,21,7,14,0,Badal,2000,
1400,21,4,17,0,Bawandar,2000,
1401,16,4,12,0,Beti No. 1,2000,
1402,19,3,16,0,Bichhoo,2000,
1403,11,3,8,0,Bulandi,2000,
1404,24,8,16,0,Chal Mere Bhai,2000,
1405,18,6,12,0,Champion,2000,
1406,11,1,10,0,Cover Story,2000,
1407,23,8,15,0,Deewane,2000,
1408,24,9,15,0,Dhaai Akshar Prem Ke,2000,
1409,13,7,6,0,Dhadkan,2000,
1410,42,6,36,0,Dil Pe Mat Le Yaar!!,2000,
1411,17,6,11,0,Dr. Babasaheb Ambedkar,2000,
1412,14,5,9,0,Dulhan Hum Le Jayenge,2000,
1413,29,10,19,0,Fiza,2000,
1414,18,12,6,0,Gaja Gamini,2000,
1415,18,4,14,0,Gang,2000,
1416,18,5,13,0,Ghaath,2000,
1417,23,9,14,0,Hadh Kar Di Aapne,2000,
1418,32,13,19,0,Hamara Dil Aapke Paas Hai,2000,
1419,20,6,14,0,Har Dil Jo Pyar Karega...,2000,
1420,9,6,3,0,Hari-Bhari,2000,
1421,17,5,12,0,Hera Pheri,2000,
1422,93,29,64,0,Hey Ram,2000,
1423,14,3,11,0,Hum To Mohabbat Karega,2000,
1424,16,5,11,0,Jis Desh Mein Ganga Rehta Hain,2000,
1425,15,5,10,0,Joru Ka Ghulam,2000,
1426,14,5,9,0,Josh,2000,
1427,22,7,15,0,Jung,2000,
1428,19,3,16,0,Jungle,2000,
1429,14,5,9,0,Kahin Pyaar Na Ho Jaaye,2000,
1430,21,8,13,0,Kaho Naa... Pyaar Hai,2000,
1431,12,4,8,0,Karobaar: The Business of Love,2000,
1432,20,5,15,0,Khauff,2000,
1433,24,7,17,0,Khiladi 420,2000,
1434,14,5,9,0,Krodh,2000,
1435,14,4,10,0,Kunwara,2000,
1436,16,6,10,0,Kurukshetra,2000,
1437,13,6,7,0,Kya Kehna,2000,
1438,33,7,26,0,Mela,2000,
1439,46,8,38,0,Mission Kashmir,2000,
1440,34,17,17,0,Mohabbatein,2000,
1441,18,3,15,0,Papa the Great,2000,
1442,37,20,17,0,Paromitar Ek Din,2000,
1443,22,7,15,0,Phir Bhi Dil Hai Hindustani,2000,
1444,5,2,3,0,Priyamanavale,2000,
1445,15,4,11,0,Pukar,2000,
1446,30,14,16,0,Raja Ko Rani Se Pyar Ho Gaya,2000,
1447,24,6,18,0,Raju Chacha,2000,
1448,14,3,11,0,Refugee,2000,
1449,11,2,9,0,Satyameva Jayate,2000,
1450,20,6,14,0,Shikari,2000,
1451,9,9,0,0,Snegithiye,2000,
1452,6,3,3,0,Snip!,2000,
1453,32,13,19,0,Tarkieb,2000,
1454,28,7,21,0,Tera Jadoo Chal Gayaa,2000,
1455,20,7,13,0,Tere Pyaar Mein,2000,
1456,10,3,7,0,The Prince of Light,2000,
1457,2,0,2,0,Uyirile Kalanthathu,2000,
1458,17,5,12,0,Yuvaraju,2000,
1459,14,6,8,0,Aalavandhan,2001,
1460,24,7,17,0,Aamdani Atthanni Kharcha Rupaiya,2001,
1461,16,6,10,0,Aashiq,2001,
1462,18,6,12,0,Afsana Dilwalon Ka,2001,
1463,18,6,12,0,Ajnabee,2001,
1464,18,3,15,0,Aks,2001,
1465,9,3,6,0,Albela,2001,
1466,52,12,40,0,Asoka,2001,
1467,13,4,9,0,Bas Itna Sa Khwaab Hai...,2001,
1468,79,34,45,0,Censor,2001,
1469,53,11,42,0,Chandni Bar,2001,
1470,13,3,10,0,Chhupa Rustam: A Musical Thriller,2001,
1471,13,6,7,0,Chori Chori Chupke Chupke,2001,
1472,10,3,7,0,Daddy,2001,
1473,17,9,8,0,Daman: A Victim of Marital Violence,2001,
1474,19,4,15,0,Deewaanapan,2001,
1475,10,2,8,0,Dhill,2001,
1476,28,15,13,0,Dil Chahta Hai,2001,
1477,11,4,7,0,Dil Ne Phir Yaad Kiya,2001,
1478,2,2,0,0,Dilwale:The Brave Heart,2001,
1479,22,4,18,0,Eduruleni Manishi,2001,
1480,10,4,6,0,Ehsaas: The Feeling,2001,
1481,22,6,16,0,Ek Rishtaa: The Bond of Love,2001,
1482,72,33,39,0,Everybody Says I'm Fine!,2001,
1483,11,3,8,0,Farz,2001,
1484,26,8,18,0,Gadar: Ek Prem Katha,2001,
1485,8,2,6,0,Grahan,2001,
1486,23,10,13,0,Hum Ho Gaye Aap Ke,2001,
1487,39,5,34,0,Indian,2001,
1488,14,4,10,0,Itlu Sravani Subramanyam,2001,
1489,37,3,34,0,Ittefaq,2001,
1490,31,6,25,0,Jodi No.1,2001,
1491,37,16,21,0,Kabhi Khushi Kabhie Gham...,2001,
1492,27,7,20,0,Kasam,2001,
1493,18,6,12,0,Kasoor,2001,
1494,12,5,7,0,Kuch Khatti Kuch Meethi,2001,
1495,30,6,24,0,Kyo Kii... Main Jhuth Nahin Bolta,2001,
1496,38,5,33,0,Lagaan: Once Upon a Time in India,2001,
1497,65,27,38,0,Lajja,2001,
1498,22,3,19,0,Love Ke Liye Kuch Bhi Karega,2001,
1499,11,6,5,0,Love You Hamesha,2001,
1500,2,2,0,0,Mahakali Ka Insaaf,2001,
1501,12,4,8,0,Majunu,2001,
1502,15,3,12,0,Maya,2001,
1503,18,9,9,0,Moksha: Salvation,2001,
1504,47,25,22,0,Monsoon Wedding,2001,
1505,32,8,24,0,Mrugaraaju,2001,
1506,14,5,9,0,Mujhe Kucch Kehna Hai,2001,
1507,13,5,8,0,Mujhe Meri Biwi Se Bachaao,2001,
1508,9,3,6,0,Nandha,2001,
1509,15,5,10,0,Narasimha Nayudu,2001,
1510,27,5,22,0,Nayak: The Real Hero,2001,
1511,10,2,8,0,Officer,2001,
1512,15,4,11,0,One 2 Ka 4,2001,
1513,6,3,3,0,Prematho Raa,2001,
1514,33,13,20,0,Pyaar Ishq Aur Mohabbat,2001,
1515,6,3,3,0,Pyaar Tune Kya Kiya...,2001,
1516,28,9,19,0,Rahul,2001,
1517,11,5,6,0,Rehnaa Hai Terre Dil Mein,2001,
1518,10,2,8,0,Samsara,2001,
1519,18,5,13,0,Shirdi Sai Baba,2001,
1520,17,3,14,0,Student No. 1,2001,
1521,18,6,12,0,Style,2001,
1522,26,6,20,0,Tera Mera Saath Rahen,2001,
1523,17,5,12,0,Thavasi,2001,
1524,24,6,18,0,The Warrior,2001,
1525,14,5,9,0,Tum Bin...: Love Will Find a Way,2001,
1526,8,0,8,0,Veer Savarkar,2001,
1527,20,11,9,0,Yaadein...,2001,
1528,15,6,9,0,Yeh Raaste Hain Pyaar Ke,2001,
1529,12,5,7,0,Yeh Teraa Ghar Yeh Meraa Ghar,2001,
1530,5,2,3,0,Yeh Zindagi Ka Safar,2001,
1531,23,9,14,0,Zubeidaa,2001,
1532,6,3,3,0,16-Dec,2002,
1533,24,4,20,0,23rd March 1931: Shaheed,2002,
1534,10,0,10,0,Aamaar Bhuvan,2002,
1535,21,4,17,0,Aankhen,2002,
1536,18,4,14,0,Aap Mujhe Achche Lagne Lage,2002,
1537,29,6,23,0,Ab Ke Baras,2002,
1538,31,7,24,0,Agni Varsha,2002,
1539,22,4,18,0,Akhiyon Se Goli Maare,2002,
1540,12,5,7,0,Allari Ramudu,2002,
1541,36,18,18,0,Anita & Me,2002,
1542,16,4,12,0,Annarth,2002,
1543,11,4,7,0,Awara Paagal Deewana,2002,
1544,16,4,12,0,Badhaai Ho Badhaai,2002,
1545,42,24,18,0,Bend It Like Beckham,2002,
1546,19,6,13,0,Bollywood Queen,2002,
1547,57,32,25,0,Bollywood/Hollywood,2002,
1548,31,6,25,0,Bomb the System,2002,
1549,21,3,18,0,Chalo Ishq Ladaaye,2002,
1550,13,6,7,0,Chandu,2002,
1551,22,6,16,0,Chenna Kesava Reddy,2002,
1552,10,1,9,0,Chhal,2002,
1553,17,4,13,0,Chor Machaaye Shor,2002,
1554,27,8,19,0,Company,2002,
1555,22,8,14,0,Deewangee,2002,
1556,31,16,15,0,Devdas,2002,
1557,20,8,12,0,Dil Hai Tumhaara,2002,
1558,22,10,12,0,Dil Vil Pyar Vyar,2002,
1559,5,3,2,0,Ek Chhotisi Love Story,2002,
1560,9,2,7,0,Encounter: The Killing,2002,
1561,18,9,9,0,Filhaal...,2002,
1562,14,3,11,0,Gemini,2002,
1563,17,4,13,0,Gunaah,2002,
1564,16,9,7,0,Haan Maine Bhi Pyaar Kiya,2002,
1565,44,9,35,0,Hathyar: Face to Face with Reality,2002,
1566,21,3,18,0,Hum Kisi Se Kum Nahin,2002,
1567,14,6,8,0,Hum Tumhare Hain Sanam,2002,
1568,24,7,17,0,Humraaz,2002,
1569,28,7,21,0,Jaani Dushman: Ek Anokhi Kahani,2002,
1570,8,3,5,0,Jeena Sirf Merre Liye,2002,
1571,35,13,22,0,Kaante,2002,
1572,7,2,5,0,Kali Salwaar,2002,
1573,24,4,20,0,Karz: The Burden of Truth,2002,
1574,19,7,12,0,Kehtaa Hai Dil Baar Baar,2002,
1575,32,12,20,0,Kitne Door... Kitne Paas,2002,
1576,6,3,3,0,Koi Mere Dil Se Poochhe,2002,
1577,19,3,16,0,Kranti,2002,
1578,17,7,10,0,Kuch Tum Kaho Kuch Hum Kahein,2002,
1579,13,4,9,0,Kya Yehi Pyaar Hai,2002,
1580,20,7,13,0,Kyaa Dil Ne Kahaa,2002,
1581,21,4,17,0,Lal Salaam,2002,
1582,9,3,6,0,Maa Tujhhe Salaam,2002,
1583,10,4,6,0,Maine Dil Tujhko Diya,2002,
1584,15,4,11,0,Makdee,2002,
1585,28,4,24,0,Maseeha,2002,
1586,13,8,5,0,Mere Yaar Ki Shaadi Hai,2002,
1587,86,53,33,0,Mitr: My Friend,2002,
1588,6,3,3,0,Mounam Pesiyadhe,2002,
1589,36,14,22,0,Mr. and Mrs. Iyer,2002,
1590,12,6,6,0,Mujhse Dosti Karoge!,2002,
1591,26,16,10,0,Na Tum Jaano Na Hum,2002,
1592,11,3,8,0,Nandhi,2002,
1593,24,8,16,0,Om Jai Jagadish,2002,
1594,21,5,16,0,Pitaah,2002,
1595,21,8,13,0,Pyaar Diwana Hota Hai,2002,
1596,9,3,6,0,Pyaasa,2002,
1597,18,8,10,0,Raaz,2002,
1598,12,2,10,0,Ramana,2002,
1599,21,5,16,0,Rishtey,2002,
1600,8,2,6,0,Road,2002,
1601,53,23,30,0,Saathiya,2002,
1602,18,7,11,0,Santosham,2002,
1603,28,8,20,0,Seema Simham,2002,
1604,18,7,11,0,Shakthi: The Power,2002,
1605,20,6,14,0,Shararat,2002,
1606,8,3,5,0,Soch,2002,
1607,25,12,13,0,Sur: The Melody of Life,2002,
1608,10,1,9,0,Thamizhan,2002,
1609,93,39,54,0,The Guru,2002,
1610,90,7,83,0,The Legend of Bhagat Singh,2002,
1611,14,6,8,0,Tum Se Achcha Kaun Hai,2002,
1612,18,4,14,0,Tumko Na Bhool Paayenge,2002,
1613,8,3,5,0,Vadh,2002,
1614,14,5,9,0,Waah! Tera Kya Kehna,2002,
1615,27,8,19,0,Yeh Dil Aashiqanaa,2002,
1616,14,3,11,0,Yeh Hai Jalwa,2002,
1617,9,3,6,0,Yeh Kya Ho Raha Hai?,2002,
1618,23,6,17,0,Yeh Mohabbat Hai,2002,
1619,10,3,7,0,3 Deewarein,2003,
1620,11,4,7,0,88 Antop Hill,2003,
1621,13,4,9,0,Aanch,2003,
1622,15,7,8,0,Aapko Pehle Bhi Kahin Dekha Hai,2003,
1623,25,6,19,0,Anbe Sivam,2003,
1624,24,10,14,0,Andaaz,2003,
1625,9,2,7,0,Anjaneya,2003,
1626,15,6,9,0,Armaan,2003,
1627,13,5,8,0,Baaz: A Bird in Danger,2003,
1628,27,9,18,0,Baghban,2003,
1629,14,7,7,0,Bhoot,2003,
1630,17,6,11,0,Boom,2003,
1631,17,4,13,0,Border Hindustan Ka,2003,
1632,13,2,11,0,Calcutta Mail,2003,
1633,33,9,24,0,Chalte Chalte,2003,
1634,14,5,9,0,Chameli,2003,
1635,9,4,5,0,Chori Chori,2003,
1636,9,3,6,0,Chota Jadugar,2003,
1637,10,4,6,0,Chupke Se,2003,
1638,9,3,6,0,Chura Liyaa Hai Tumne,2003,
1639,14,3,11,0,Daai zek lou,2003,
1640,17,5,12,0,Darna Mana Hai,2003,
1641,14,5,9,0,Dhoop,2003,
1642,18,5,13,0,Dhund: The Fog,2003,
1643,13,5,8,0,Dil Ka Rishta,2003,
1644,21,7,14,0,Dil Pardesi Ho Gayaa,2003,
1645,30,6,24,0,Dum,2003,
1646,8,3,5,0,Ek Din 24 Ghante,2003,
1647,64,24,40,0,Escape from Taliban,2003,
1648,15,3,12,0,Footpath,2003,
1649,22,6,16,0,Fun2shh... Dudes in the 10th Century,2003,
1650,15,4,11,0,Gangaajal,2003,
1651,14,5,9,0,Gangotri,2003,
1652,15,2,13,0,Haasil,2003,
1653,13,5,8,0,Hawa,2003,
1654,21,6,15,0,Hawayein,2003,
1655,75,12,63,0,Hazaaron Khwaishein Aisi,2003,
1656,4,2,2,0,Hollywood,2003,
1657,15,5,10,0,Hungama,2003,
1658,9,3,6,0,Inteha,2003,
1659,32,16,16,0,Ishq Vishk,2003,
1660,21,6,15,0,Jaal: The Trap,2003,
1661,8,3,5,0,Jajantaram Mamantaram,2003,
1662,17,6,11,0,Janasheen,2003,
1663,15,6,9,0,Jhankaar Beats,2003,
1664,10,3,7,0,Jism,2003,
1665,10,4,6,0,Joggers' Park,2003,
1666,11,6,5,0,Kadhal Sadugudu,2003,
1667,41,27,14,0,Kal Ho Naa Ho,2003,
1668,12,4,8,0,Kash... Aap Hamare Hote,2003,
1669,12,3,9,0,Khel,2003,
1670,17,7,10,0,Khushi,2003,
1671,6,1,5,0,Khwahish,2003,
1672,12,3,9,0,Kiccha,2003,
1673,32,12,20,0,Koi... Mil Gaya,2003,
1674,19,8,11,0,Kucch To Hai,2003,
1675,23,13,10,0,Kuch Naa Kaho,2003,
1676,47,11,36,0,LOC: Kargil,2003,
1677,17,5,12,0,Love at Times Square,2003,
1678,9,2,7,0,Main Madhuri Dixit Banna Chahti Hoon!,2003,
1679,24,15,9,0,Main Prem Ki Diwani Hoon,2003,
1680,30,6,24,0,Maqbool,2003,
1681,39,17,22,0,Market,2003,
1682,24,1,23,0,Matrubhoomi: A Nation Without Women,2003,
1683,8,6,2,0,Miss India: The Mystery,2003,
1684,12,4,8,0,Mumbai Matinee,2003,
1685,12,2,10,0,Mumbai Se Aaya Mera Dost,2003,
1686,22,6,16,0,Munna Bhai M.B.B.S.,2003,
1687,19,7,12,0,Naaga,2003,
1688,8,2,6,0,Nayee Padosan,2003,
1689,7,3,4,0,Oops!,2003,
1690,4,2,2,0,Ottran,2003,
1691,15,6,9,0,Out of Control,2003,
1692,15,3,12,0,Paanch,2003,
1693,35,8,27,0,Paap,2003,
1694,3,2,1,0,Partha,2003,
1695,27,5,22,0,Parwana,2003,
1696,21,10,11,0,Pinjar: Beyond Boundaries...,2003,
1697,25,12,13,0,Pran Jaaye Par Shaan Na Jaaye,2003,
1698,7,3,4,0,Pudhiya Geethai,2003,
1699,25,5,20,0,Qayamat: City Under Threat,2003,
1700,9,5,4,0,Raghavendra,2003,
1701,47,16,31,0,Raghu Romeo,2003,
1702,20,6,14,0,Raja Bhaiya,2003,
1703,11,5,6,0,Rules: Pyaar Ka Superhit Formula,2003,
1704,8,4,4,0,Saaya,2003,
1705,13,5,8,0,Samay: When Time Strikes,2003,
1706,45,13,32,0,Satta,2003,
1707,12,4,8,0,Shivamani,2003,
1708,19,10,9,0,Sssshhh...,2003,
1709,17,4,13,0,Stumped,2003,
1710,12,4,8,0,Supari,2003,
1711,38,12,26,0,Talaash: The Hunt Begins...,2003,
1712,13,9,4,0,Tehzeeb,2003,
1713,41,7,34,0,Tere Naam,2003,
1714,16,5,11,0,The Hero: Love Story of a Spy,2003,
1715,17,10,7,0,Tujhe Meri Kasam,2003,
1716,46,10,36,0,Waisa Bhi Hota Hai Part II,2003,
1717,64,21,43,0,Where's the Party Yaar?,2003,
1718,17,5,12,0,Winner,2003,
1719,10,4,6,0,Xcuse Me,2003,
1720,28,11,17,0,Yeh Dil,2003,
1721,24,2,22,0,Zameen,2003,
1722,9,4,5,0,Aabra Ka Daabra,2004,
1723,21,5,16,0,Aan: Men at Work,2004,
1724,16,4,12,0,Ab Tak Chhappan,2004,
1725,17,4,13,0,Ab Tumhare Hawale Watan Saathiyo,2004,
1726,16,6,10,0,Ab... Bas!,2004,
1727,15,6,9,0,Aetbaar,2004,
1728,19,5,14,0,Agni Pankh,2004,
1729,14,5,9,0,Aitraaz,2004,
1730,16,9,7,0,Anji,2004,
1731,15,4,11,0,Arjun,2004,
1732,56,10,46,0,Around the World in 80 Days,2004,
1733,22,5,17,0,Asambhav,2004,
1734,14,2,12,0,Bardaasht,2004,
1735,45,3,42,0,Black Friday,2004,
1736,27,15,12,0,Bride & Prejudice,2004,
1737,16,2,14,0,Charas: A Joint Effort,2004,
1738,25,3,22,0,Deewaar: Let's Bring Our Heroes Home,2004,
1739,13,2,11,0,Dev,2004,
1740,19,4,15,0,Dhoom,2004,
1741,23,6,17,0,Dil Maange More!!!,2004,
1742,25,9,16,0,Dil Ne Jise Apna Kaha,2004,
1743,9,3,6,0,Dobara,2004,
1744,17,9,8,0,Ek Hasina Thi,2004,
1745,12,2,10,0,Ek Se Badhkar Ek,2004,
1746,10,3,7,0,Fida,2004,
1747,28,4,24,0,Garv: Pride and Honour,2004,
1748,7,2,5,0,Gayab,2004,
1749,17,8,9,0,Ghar Grihasti,2004,
1750,10,4,6,0,Girlfriend,2004,
1751,4,1,3,0,Hari Om,2004,
1752,42,8,34,0,Harold & Kumar Go to White Castle,2004,
1753,17,2,15,0,Hatya: The Murder,2004,
1754,23,13,10,0,Hava Aney Dey,2004,
1755,11,4,7,0,Hawas,2004,
1756,20,7,13,0,Hulchul,2004,
1757,14,5,9,0,Hum Kaun Hai?,2004,
1758,20,9,11,0,Hum Tum,2004,
1759,4,2,2,0,Hyderabad Blues 2,2004,
1760,17,2,15,0,I Proud to Be an Indian,2004,
1761,11,3,8,0,Insaaf: The Justice,2004,
1762,22,8,14,0,Inteqam: The Perfect Game,2004,
1763,11,5,6,0,Ishq Hai Tumse,2004,
1764,33,7,26,0,Jaago,2004,
1765,17,3,14,0,Julie,2004,
1766,60,13,47,0,Khakee,2004,
1767,16,3,13,0,Kis Kis Ki Kismat,2004,
1768,11,2,9,0,Kismat,2004,
1769,12,6,6,0,Krishna Cottage,2004,
1770,14,5,9,0,Kyun! Ho Gaya Na...,2004,
1771,22,2,20,0,Lakeer - Forbidden Lines,2004,
1772,49,6,43,0,Lakshya,2004,
1773,14,3,11,0,Let's Enjoy,2004,
1774,12,4,8,0,Love in Nepal,2004,
1775,16,7,9,0,Madhoshi,2004,
1776,12,5,7,0,Madurey,2004,
1777,3,1,2,0,Main Hoon Khiladiyon Ka Khiladi,2004,
1778,19,6,13,0,Main Hoon Na,2004,
1779,2,2,0,0,Man on Mission Fauladi,2004,
1780,38,14,24,0,Manasarovar,2004,
1781,12,2,10,0,Mass,2004,
1782,27,12,15,0,Masti,2004,
1783,19,8,11,0,Meenaxi: Tale of 3 Cities,2004,
1784,24,7,17,0,Meri Biwi Ka Jawab Nahin,2004,
1785,9,4,5,0,Morning Raga,2004,
1786,19,7,12,0,Mujhse Shaadi Karogi,2004,
1787,10,5,5,0,Murder,2004,
1788,20,5,15,0,Musafir,2004,
1789,9,3,6,0,Muskaan,2004,
1790,8,2,6,0,Naach,2004,
1791,15,5,10,0,Nalla,2004,
1792,22,6,16,0,Navra Mazha Navsacha,2004,
1793,15,5,10,0,Nenunnanu,2004,
1794,8,4,4,0,Paisa Vasool,2004,
1795,9,3,6,0,Phir Milenge,2004,
1796,13,4,9,0,Plan,2004,
1797,11,2,9,0,Police Force: An Inside Story,2004,
1798,15,5,10,0,Popcorn Khao! Mast Ho Jao,2004,
1799,6,3,3,0,Raincoat,2004,
1800,25,9,16,0,Rakht,2004,
1801,9,4,5,0,Ranga S.S.L.C,2004,
1802,18,8,10,0,Rok Sako To Rok Lo,2004,
1803,11,4,7,0,Rudraksh,2004,
1804,34,10,24,0,Run,2004,
1805,14,5,9,0,Samba,2004,
1806,21,10,11,0,Sau Jhooth Ek Sach,2004,
1807,7,4,3,0,Shaadi Ka Laddoo,2004,
1808,10,4,6,0,Shart: The Challenge,2004,
1809,6,2,4,0,Sheen,2004,
1810,9,4,5,0,Shukriya: Till Death Do Us Apart,2004,
1811,5,2,3,0,Sullan,2004,
1812,26,6,20,0,Suno Sasurjee,2004,
1813,18,4,14,0,"Swades: We, the People",2004,
1814,16,2,14,0,Taarzan: The Wonder Car,2004,
1815,9,3,6,0,Tauba Tauba,2004,
1816,34,13,21,0,Tum: A Dangerous Obsession,2004,
1817,14,5,9,0,Tumsa Nahin Dekha,2004,
1818,12,7,5,0,Vaastu Shastra,2004,
1819,36,6,30,0,Veer-Zaara,2004,
1820,7,3,4,0,Wajahh: A Reason to Kill,2004,
1821,8,4,4,0,White Rainbow,2004,
1822,12,3,9,0,Yagnam,2004,
1823,9,3,6,0,Yeh Lamhe Judaai Ke,2004,
1824,9,4,5,0,Yuva,2004,
1825,28,2,26,0,'D',2005,
1826,13,5,8,0,...Yahaan,2005,
1827,47,19,28,0,15 Park Avenue,2005,
1828,27,12,15,0,7 1/2 Phere: More Than a Wedding,2005,
1829,4,2,2,0,A Film by Aravind,2005,
1830,21,8,13,0,A Sublime Love Story: Barsaat,2005,
1831,8,4,4,0,Aashiq Banaya Aapne: Love Takes Over,2005,
1832,16,5,11,0,Allari Pidugu,2005,
1833,28,13,15,0,Amu,2005,
1834,25,5,20,0,Andarivaadu,2005,
1835,10,2,8,0,Andhrudu,2005,
1836,15,7,8,0,Anjaane: The Unkown,2005,
1837,17,3,14,0,Anniyan,2005,
1838,19,6,13,0,Antarmahal: Views of the Inner Chamber,2005,
1839,223,25,198,0,Apaharan,2005,
1840,27,3,24,0,Athadu,2005,
1841,9,3,6,0,Bachke Rehna Re Baba,2005,
1842,21,11,10,0,Bewafaa,2005,
1843,16,4,12,0,Bhageeratha,2005,
1844,22,10,12,0,Black,2005,
1845,15,4,11,0,Blackmail,2005,
1846,42,12,30,0,Bluffmaster!,2005,
1847,16,3,13,0,Bunny,2005,
1848,47,9,38,0,Bunty Aur Babli,2005,
1849,6,3,3,0,C U at 9,2005,
1850,9,3,6,0,Chaahat Ek Nasha...,2005,
1851,19,6,13,0,Chatrapathi,2005,
1852,11,4,7,0,Chehraa,2005,
1853,44,29,15,0,Chicken Tikka Masala,2005,
1854,14,5,9,0,Chocolate: Deep Dark Secrets,2005,
1855,12,5,7,0,Daas,2005,
1856,4,1,3,0,Dansh,2005,
1857,18,4,14,0,Deewane Huye Paagal,2005,
1858,10,6,4,0,Dil Jo Bhi Kahey...,2005,
1859,14,8,6,0,Dosti: Friends Forever,2005,
1860,19,7,12,0,Dus,2005,
1861,15,3,12,0,Ek Ajnabee,2005,
1862,20,6,14,0,Ek Khiladi Ek Haseena,2005,
1863,20,4,16,0,Elaan,2005,
1864,15,3,12,0,Fareb,2005,
1865,9,4,5,0,Film Star,2005,
1866,13,5,8,0,Fun: Can Be Dangerous Sometimes,2005,
1867,43,8,35,0,Game 6,2005,
1868,12,7,5,0,Garam Masala,2005,
1869,35,3,32,0,Hanuman,2005,
1870,14,3,11,0,Hei ma lai ah sing,2005,
1871,34,9,25,0,Home Delivery: Aapko... Ghar Tak,2005,
1872,5,2,3,0,Hum Dum,2005,
1873,36,9,27,0,Insan,2005,
1874,19,4,15,0,Iqbal,2005,
1875,14,2,12,0,James,2005,
1876,18,7,11,0,Jo Bole So Nihaal,2005,
1877,3,2,1,0,Jogi the King,2005,
1878,9,2,7,0,Jurm,2005,
1879,16,4,12,0,Kaal,2005,
1880,13,5,8,0,Kal: Yesterday and Tomorrow,2005,
1881,17,6,11,0,Kalyug,2005,
1882,16,3,13,0,Karam,2005,
1883,22,7,15,0,Kasak,2005,
1884,23,7,16,0,Khamoshh... Khauff Ki Raat,2005,
1885,17,4,13,0,Khullam Khulla Pyaar Karen,2005,
1886,36,13,23,0,Kisna: The Warrior Poet,2005,
1887,17,8,9,0,Koi Aap Sa: But Lovers Have to Be Friends,2005,
1888,15,7,8,0,Koi Mere Dil Mein Hai,2005,
1889,19,9,10,0,Kuchh Meetha Ho Jaye,2005,
1890,22,8,14,0,Kyaa Kool Hai Hum,2005,
1891,18,3,15,0,Kyon Ki...,2005,
1892,8,4,4,0,La mujer de mi hermano,2005,
1893,13,7,6,0,Lucky: No Time for Love,2005,
1894,13,7,6,0,Main Aisa Hi Hoon,2005,
1895,48,19,29,0,"Main, Meri Patni... Aur Woh!",2005,
1896,21,6,15,0,Maine Gandhi Ko Nahin Mara,2005,
1897,16,6,10,0,Maine Pyaar Kyun Kiya,2005,
1898,1,0,1,0,Man On Mission Jaanbaaz,2005,
1899,3,2,1,0,Man on Mission Taqatwar,2005,
1900,90,18,72,0,Mangal Pandey: The Rising,2005,
1901,12,3,9,0,Mr Prime Minister,2005,
1902,14,5,9,0,Mr Ya Miss,2005,
1903,17,6,11,0,Mumbai Express,2005,
1904,19,8,11,0,My Brother... Nikhil,2005,
1905,13,5,8,0,My Wife's Murder,2005,
1906,7,3,4,0,Naam Gum Jaayega,2005,
1907,12,5,7,0,Naina,2005,
1908,23,5,18,0,Narasimhudu,2005,
1909,13,7,6,0,Nazar,2005,
1910,31,15,16,0,Neal 'N' Nikki,2005,
1911,42,7,35,0,Netaji Subhas Chandra Bose: The Forgotten Hero,2005,
1912,22,8,14,0,No Entry,2005,
1913,12,7,5,0,Padmashree Laloo Prasad Yadav,2005,
1914,33,11,22,0,Page 3,2005,
1915,22,9,13,0,Paheli,2005,
1916,38,17,21,0,Parineeta,2005,
1917,10,3,7,0,Parzania,2005,
1918,13,4,9,0,Pehchaan: The Face of Truth,2005,
1919,11,8,3,0,Priyasakhi,2005,
1920,13,7,6,0,Pyaar Mein Twist,2005,
1921,5,2,3,0,Rain: The Terror Within...,2005,
1922,32,14,18,0,Ramji Londonwaley,2005,
1923,9,2,7,0,Rog,2005,
1924,12,4,8,0,Sachein,2005,
1925,29,13,16,0,Salaam Namaste,2005,
1926,16,3,13,0,Sandai Kozhi,2005,
1927,30,7,23,0,Sarkar,2005,
1928,14,3,11,0,Sehar,2005,
1929,16,6,10,0,Shaadi No. 1,2005,
1930,13,4,9,0,Shabd,2005,
1931,20,11,9,0,Sheesha,2005,
1932,15,3,12,0,Shikhar,2005,
1933,19,9,10,0,Silsiilay,2005,
1934,3,1,2,0,Sins,2005,
1935,5,3,2,0,Siskiyaan,2005,
1936,16,7,9,0,Socha Na Tha,2005,
1937,18,3,15,0,Subhash Chandra Bose,2005,
1938,11,3,8,0,Super,2005,
1939,11,5,6,0,Taj Mahal: An Eternal Love Story,2005,
1940,19,2,17,0,Tango Charlie,2005,
1941,45,12,33,0,The Blue Umbrella,2005,
1942,21,5,16,0,The Film,2005,
1943,57,27,30,0,The Great New Wonderful,2005,
1944,19,6,13,0,The Hangman,2005,
1945,13,1,12,0,Vaada,2005,
1946,22,8,14,0,Vaah! Life Ho Toh Aisi!,2005,
1947,15,4,11,0,Veerabhadra,2005,
1948,18,5,13,0,Viruddh... Family Comes First,2005,
1949,10,3,7,0,Waqt: The Race Against Time,2005,
1950,41,29,12,0,Water,2005,
1951,7,2,5,0,Yakeen,2005,
1952,15,8,7,0,Zameer,2005,
1953,8,3,5,0,Zeher,2005,
1954,22,10,12,0,36 China Town,2006,
1955,16,9,7,0,Aap Ki Khatir,2006,
1956,15,2,13,0,Aathi,2006,
1957,22,7,15,0,Aatma,2006,
1958,8,3,5,0,Ahista Ahista,2006,
1959,8,2,6,0,Aksar,2006,
1960,21,7,14,0,Alag: He Is Different.... He Is Alone...,2006,
1961,14,4,10,0,Ankahee,2006,
1962,9,2,7,0,Anthony Kaun Hai?,2006,
1963,80,30,50,0,Anuranan,2006,
1964,12,3,9,0,Apna Sapna Money Money,2006,
1965,9,3,6,0,Aryan: Unbreakable,2006,
1966,17,6,11,0,Baabul,2006,
1967,11,6,5,0,Banaras,2006,
1968,28,8,20,0,Bangaram,2006,
1969,15,4,11,0,Bas Ek Pal,2006,
1970,21,9,12,0,Bhagam Bhag,2006,
1971,27,5,22,0,Bhoot Unkle,2006,
1972,24,8,16,0,Boss,2006,
1973,15,7,8,0,Chingaari,2006,
1974,14,6,8,0,Chup Chup Ke,2006,
1975,9,2,7,0,Come December,2006,
1976,90,30,60,0,Corporate,2006,
1977,20,10,10,0,Darna Zaroori Hai,2006,
1978,24,6,18,0,Darwaza Bandh Rakho,2006,
1979,22,7,15,0,Deadline: Sirf 24 Ghante,2006,
1980,16,4,12,0,Dhoom:2,2006,
1981,15,6,9,0,Dil Diya Hai,2006,
1982,37,8,29,0,Don,2006,
1983,20,7,13,0,Dor,2006,
1984,33,14,19,0,Efter brylluppet,2006,
1985,73,20,53,0,Family: Ties of Blood,2006,
1986,29,10,19,0,Fanaa,2006,
1987,4,2,2,0,Faryad moorcheha,2006,
1988,27,8,19,0,Fight Club: Members Only,2006,
1989,18,9,9,0,Finding Preet,2006,
1990,8,2,6,0,Gafla,2006,
1991,5,1,4,0,Ganga,2006,
1992,8,1,7,0,Gangster,2006,
1993,14,2,12,0,Golmaal: Fun Unlimited,2006,
1994,9,6,3,0,Holiday,2006,
1995,13,2,11,0,Hubballi,2006,
1996,22,12,10,0,Humko Deewana Kar Gaye,2006,
1997,13,5,8,0,Humko Tumse Pyaar Hai,2006,
1998,8,3,5,0,Hyderabad Nawabs,2006,
1999,16,5,11,0,I See You,2006,
2000,19,6,13,0,Jaan-E-Mann: Let's Fall in Love... Again,2006,
2001,8,4,4,0,Jaane Hoga Kya,2006,
2002,11,3,8,0,Jawani Diwani: A Youthful Joyride,2006,
2003,13,4,9,0,Jigyaasa,2006,
2004,82,29,53,0,Kabhi Alvida Naa Kehna,2006,
2005,39,3,36,0,Kabul Express,2006,
2006,27,11,16,0,Khan kluay,2006,
2007,28,6,22,0,Khosla Ka Ghosla!,2006,
2008,17,7,10,0,Krrish,2006,
2009,8,4,4,0,Kudiyon Ka Hai Zamaana,2006,
2010,16,8,8,0,Ladies Tailor,2006,
2011,36,5,31,0,Lage Raho Munna Bhai,2006,
2012,13,6,7,0,Malamaal Weekly,2006,
2013,10,4,6,0,Mera Dil Leke Dekho,2006,
2014,15,4,11,0,Mere Jeevan Saathi,2006,
2015,19,6,13,0,Mixed Doubles,2006,
2016,10,4,6,0,My Bollywood Bride,2006,
2017,13,5,8,0,Naksha,2006,
2018,5,1,4,0,Naughty Boy,2006,
2019,12,3,9,0,Omkara,2006,
2020,29,7,22,0,Outsourced,2006,
2021,34,4,30,0,Phir Hera Pheri,2006,
2022,9,6,3,0,Pyaar Ke Side Effects,2006,
2023,14,2,12,0,Pyare Mohan,2006,
2024,17,5,12,0,Rang De Basanti,2006,
2025,20,8,12,0,Return to Rajapur,2006,
2026,9,3,6,0,Rocky,2006,
2027,11,4,7,0,Saawan... The Love Season,2006,
2028,15,4,11,0,Sainikudu,2006,
2029,14,6,8,0,Sandwich,2006,
2030,34,5,29,0,Sarhad Paar,2006,
2031,15,9,6,0,Shaadi Karke Phas Gaya Yaar,2006,
2032,12,3,9,0,Shaadi Se Pehle,2006,
2033,20,2,18,0,Shiva,2006,
2034,4,1,3,0,Sivappathikaaram,2006,
2035,12,2,10,0,Tathastu,2006,
2036,20,6,14,0,Taxi No. 9 2 11: Nau Do Gyarah,2006,
2037,12,5,7,0,Teesri Aankh: The Hidden Camera,2006,
2038,6,1,5,0,The Angrez,2006,
2039,10,2,8,0,The Killer,2006,
2040,38,10,28,0,The Lookalike,2006,
2041,15,7,8,0,The Memsahib,2006,
2042,54,20,34,0,The Namesake,2006,
2043,5,2,3,0,Thirupathi,2006,
2044,21,5,16,0,"Tom, Dick, and Harry",2006,
2045,11,3,8,0,Umar,2006,
2046,19,7,12,0,Umrao Jaan,2006,
2047,34,6,28,0,Valley of Flowers,2006,
2048,16,5,11,0,Vettaiyaadu Vilaiyaadu,2006,
2049,20,10,10,0,Vivah,2006,
2050,11,5,6,0,Woh Lamhe,2006,
2051,8,3,5,0,Yatra,2006,
2052,21,9,12,0,Yun Hota Toh Kya Hota,2006,
2053,13,4,9,0,Zinda,2006,
2054,9,5,4,0,Zindaggi Rocks,2006,
2055,18,1,17,0,1971,2007,
2056,12,2,10,0,50 Lakh,2007,
2057,21,6,15,0,Aaja Nachle,2007,
2058,10,4,6,0,Aalwar,2007,
2059,15,8,7,0,Aap Kaa Surroor: The Moviee - The Real Luv Story,2007,
2060,4,1,3,0,Aarya,2007,
2061,5,3,2,0,Aggar: Passion Betrayal Terror,2007,
2062,17,8,9,0,Amal,2007,
2063,2,0,2,0,Anjaam,2007,
2064,13,3,10,0,Anwar,2007,
2065,6,3,3,0,Apna Asmaan,2007,
2066,23,6,17,0,Apne,2007,
2067,29,7,22,0,Athidhi,2007,
2068,11,2,9,0,Awarapan,2007,
2069,8,3,5,0,Bheja Fry,2007,
2070,12,5,7,0,Bhool Bhulaiyaa,2007,
2071,5,1,4,0,Bhupathi,2007,
2072,21,6,15,0,Big Brother,2007,
2073,21,7,14,0,Buddha Mar Gaya,2007,
2074,23,8,15,0,Cape Karma,2007,
2075,8,5,3,0,Cash,2007,
2076,29,8,21,0,Chain Kulii Ki Main Kulii,2007,
2077,50,39,11,0,Chak De! India,2007,
2078,17,9,8,0,Cheeni Kum,2007,
2079,6,1,5,0,Chhodon Naa Yaar,2007,
2080,13,5,8,0,Darling,2007,
2081,10,7,3,0,Deha,2007,
2082,8,3,5,0,Delhii Heights,2007,
2083,25,7,18,0,Desamuduru,2007,
2084,21,1,20,0,Dhamaal,2007,
2085,27,7,20,0,Dhan Dhana Dhan Goal,2007,
2086,20,5,15,0,Dharm,2007,
2087,10,2,8,0,Dhokha,2007,
2088,12,5,7,0,Dhol,2007,
2089,13,3,10,0,Dil Dosti Etc,2007,
2090,24,12,12,0,Dus Kahaniyaan,2007,
2091,34,5,29,0,Ek Chalis Ki Last Local,2007,
2092,12,4,8,0,Eklavya,2007,
2093,9,6,3,0,Fear,2007,
2094,15,3,12,0,Fool N Final,2007,
2095,20,5,15,0,Frozen,2007,
2096,93,21,72,0,"Gandhi, My Father",2007,
2097,6,4,2,0,Gauri: The Unborn,2007,
2098,10,2,8,0,Go,2007,
2099,15,3,12,0,God Only Knows!,2007,
2100,29,9,20,0,"Good Boy, Bad Boy",2007,
2101,35,13,22,0,Guru,2007,
2102,24,11,13,0,Hattrick,2007,
2103,28,21,7,0,Heyy Babyy,2007,
2104,21,10,11,0,Honeymoon Travels Pvt. Ltd.,2007,
2105,18,7,11,0,Hotel Very Welcome,2007,
2106,32,13,19,0,It's Breaking News,2007,
2107,56,17,39,0,Jab We Met,2007,
2108,26,10,16,0,Jhoom Barabar Jhoom,2007,
2109,37,12,25,0,Johnny Gaddaar,2007,
2110,26,3,23,0,Journey Bombay to Goa: Laughter Unlimited,2007,
2111,21,9,12,0,Just Married: Marriage Was Only the Beginning!,2007,
2112,17,4,13,0,Kaafila,2007,
2113,8,6,2,0,Kaisay Kahein...,2007,
2114,47,20,27,0,Khoya Khoya Chand,2007,
2115,13,5,8,0,Kya Love Story Hai,2007,
2116,17,7,10,0,Laaga Chunari Mein Daag: Journey of a Woman,2007,
2117,31,13,18,0,Lezioni di volo,2007,
2118,23,9,14,0,Life Mein Kabhie Kabhiee,2007,
2119,15,6,9,0,Life in a Metro,2007,
2120,13,5,8,0,MP3: Mera Pehla Pehla Pyaar,2007,
2121,8,3,5,0,Manorama Six Feet Under,2007,
2122,10,4,6,0,Mumbai Salsa,2007,
2123,11,3,8,0,My Friend Ganesha,2007,
2124,71,32,39,0,Namastey London,2007,
2125,17,3,14,0,Nanhe Jaisalmer: A Dream Come True,2007,
2126,8,2,6,0,Naqaab,2007,
2127,14,5,9,0,Nehlle Pe Dehlla,2007,
2128,5,2,3,0,Nishabd,2007,
2129,18,5,13,0,No Smoking,2007,
2130,75,26,49,0,Om Shanti Om,2007,
2131,34,8,26,0,Overnight,2007,
2132,20,5,15,0,Partner,2007,
2133,6,2,4,0,Raakh: A Poem Masked in Blood,2007,
2134,25,6,19,0,Ram Gopal Varma Ki Aag,2007,
2135,9,4,5,0,Raqeeb,2007,
2136,26,12,14,0,Red Swastik,2007,
2137,8,3,5,0,Red: The Dark Side,2007,
2138,1,0,1,0,Return of Hanuman,2007,
2139,14,3,11,0,Risk,2007,
2140,17,9,8,0,Saawariya,2007,
2141,41,19,22,0,Salaam-E-Ishq,2007,
2142,18,2,16,0,Say Salaam India: 'Let's Bring the Cup Home',2007,
2143,33,16,17,0,"Se, jie",2007,
2144,9,3,6,0,Shakalaka Boom Boom,2007,
2145,51,18,33,0,Shoot on Sight,2007,
2146,26,7,19,0,Shootout at Lokhandwala,2007,
2147,9,3,6,0,Showbiz,2007,
2148,56,8,48,0,Sivaji,2007,
2149,12,6,6,0,Speed,2007,
2150,8,5,3,0,Strangers,2007,
2151,14,2,12,0,Swami,2007,
2152,53,16,37,0,Ta Ra Rum Pum,2007,
2153,36,8,28,0,Taare Zameen Par,2007,
2154,55,10,45,0,The Darjeeling Limited,2007,
2155,4,3,1,0,The Great Indian Butterfly,2007,
2156,11,4,7,0,The Last Lear,2007,
2157,17,4,13,0,The Pool,2007,
2158,10,3,7,0,The Train: Some Lines Should Never Be Crossed...,2007,
2159,18,4,14,0,Thulasi,2007,
2160,28,7,21,0,Traffic Signal,2007,
2161,10,3,7,0,Undertrial,2007,
2162,12,4,8,0,Victoria No. 203: Diamonds Are Forever,2007,
2163,18,4,14,0,Welcome,2007,
2164,13,4,9,0,1920,2008,
2165,27,3,24,0,A Wednesday,2008,
2166,11,4,7,0,Aamir,2008,
2167,9,4,5,0,Anamika: The Untold Story,2008,
2168,8,4,4,0,Antardwand,2008,
2169,11,2,9,0,Bach ke Zara,2008,
2170,31,13,18,0,Bachna Ae Haseeno,2008,
2171,19,6,13,0,Bhoothnath,2008,
2172,37,14,23,0,Bhram: An Illusion,2008,
2173,18,4,14,0,Black & White,2008,
2174,5,2,3,0,Bombay to Bangkok,2008,
2175,22,7,15,0,C Kkompany,2008,
2176,77,17,60,0,Chamku,2008,
2177,21,5,16,0,Contract,2008,
2178,6,1,5,0,Dashavatar,2008,
2179,18,5,13,0,Dasvidaniya,2008,
2180,13,7,6,0,De Taali,2008,
2181,21,4,17,0,Desh Drohi,2008,
2182,26,7,19,0,Dhoom Dadakka,2008,
2183,12,6,6,0,Dil Kabaddi,2008,
2184,29,11,18,0,Dostana,2008,
2185,13,5,8,0,Drona,2008,
2186,17,3,14,0,EMI: Liya Hai To Chukana Padega,2008,
2187,24,9,15,0,Ek Vivaah... Aisa Bhi,2008,
2188,90,56,34,0,Fashion,2008,
2189,63,36,27,0,Filth and Wisdom,2008,
2190,53,15,38,0,Firaaq,2008,
2191,31,8,23,0,Ghajini,2008,
2192,13,4,9,0,God Tussi Great Ho,2008,
2193,19,9,10,0,Golmaal Returns,2008,
2194,5,2,3,0,Gooli,2008,
2195,16,4,12,0,Gumnaam: The Mystery,2008,
2196,10,5,5,0,Haal-e-Dil,2008,
2197,78,22,56,0,Halla Bol,2008,
2198,21,10,11,0,Hari Puttar: A Comedy of Terrors,2008,
2199,27,13,14,0,Hastey Hastey Follow Your Heart,2008,
2200,12,5,7,0,Hello,2008,
2201,14,5,9,0,Heroes,2008,
2202,29,11,18,0,Hijack,2008,
2203,41,10,31,0,Hulla,2008,
2204,21,9,12,0,Jaane Tu... Ya Jaane Na,2008,
2205,9,1,8,0,Jannat: In Search of Heaven...,2008,
2206,16,5,11,0,Jimmy,2008,
2207,46,10,36,0,Jodhaa Akbar,2008,
2208,6,3,3,0,Kaamannana Makkalu,2008,
2209,11,4,7,0,Karma: Crime. Passion. Reincarnation,2008,
2210,17,7,10,0,Karzzzz,2008,
2211,30,8,22,0,Khela,2008,
2212,15,7,8,0,Kidnap,2008,
2213,16,7,9,0,Kismat Konnection,2008,
2214,54,13,41,0,Krazzy 4,2008,
2215,20,7,13,0,Love Story 2050,2008,
2216,17,2,15,0,Maan Gaye Mughall-E-Azam,2008,
2217,7,2,5,0,Maharathi,2008,
2218,7,3,4,0,Meerabai Not Out,2008,
2219,18,9,9,0,Mehbooba,2008,
2220,9,4,5,0,Mere Baap Pehle Aap,2008,
2221,10,2,8,0,Mission Istaanbul: Darr Ke Aagey Jeet Hai!,2008,
2222,33,6,27,0,Mithya,2008,
2223,49,21,28,0,Money Hai Toh Honey Hai,2008,
2224,18,7,11,0,Mr. White Mr. Black,2008,
2225,13,3,10,0,Mukhbiir,2008,
2226,34,10,24,0,Mumbai Cutting,2008,
2227,85,25,60,0,Mumbai Meri Jaan,2008,
2228,16,4,12,0,My Name Is Anthony Gonsalves,2008,
2229,7,3,4,0,"Oh, My God!!",2008,
2230,19,5,14,0,One Two Three,2008,
2231,101,23,78,0,Oye Lucky! Lucky Oye!,2008,
2232,15,4,11,0,Pazhani,2008,
2233,24,8,16,0,Phir Kabhi,2008,
2234,17,8,9,0,Phoonk,2008,
2235,26,11,15,0,Rab Ne Bana Di Jodi,2008,
2236,10,4,6,0,Race,2008,
2237,28,10,18,0,Rama Rama Kya Hai Dramaaa,2008,
2238,14,2,12,0,Ramchand Pakistani,2008,
2239,60,18,42,0,Rang Rasiya,2008,
2240,15,3,12,0,Roadside Romeo,2008,
2241,34,7,27,0,Rock On!!,2008,
2242,7,3,4,0,Ru-Ba-Ru,2008,
2243,22,11,11,0,Saas Bahu Aur Sensex,2008,
2244,18,3,15,0,Sarkar Raj,2008,
2245,5,1,4,0,Sathyam,2008,
2246,14,5,9,0,Shaurya: It Takes Courage to Make Right... Right,2008,
2247,27,10,17,0,Singh Is Kinng,2008,
2248,14,7,7,0,Sirf....: Life Looks Greener on the Other Side,2008,
2249,77,24,53,0,Slumdog Millionaire,2008,
2250,14,5,9,0,Sorry Bhai!,2008,
2251,14,4,10,0,Souryam,2008,
2252,37,12,25,0,Summer 2007,2008,
2253,19,4,15,0,Sunday,2008,
2254,17,5,12,0,Superstar,2008,
2255,33,13,20,0,Tandoori Love,2008,
2256,13,2,11,0,Tashan,2008,
2257,65,26,39,0,The Accidental Husband,2008,
2258,47,21,26,0,The Other End of the Line,2008,
2259,42,21,21,0,Thoda Pyaar Thoda Magic,2008,
2260,23,9,14,0,U Me Aur Hum,2008,
2261,11,6,5,0,Ugly Aur Pagli,2008,
2262,13,5,8,0,Via Darjeeling,2008,
2263,11,3,8,0,Visakha Express,2008,
2264,13,4,9,0,Wafaa,2008,
2265,60,15,45,0,Welcome to Sajjanpur,2008,
2266,12,6,6,0,When Kiran Met Karen,2008,
2267,12,2,10,0,Woodstock Villa,2008,
2268,34,9,25,0,Y.M.I. Yeh Mera India,2008,
2269,26,10,16,0,Yuvvraaj,2008,
2270,17,5,12,0,13B: Fear Has a New Address,2009,
2271,141,39,102,0,2012,2009,
2272,70,18,52,0,3 Idiots,2009,
2273,8,4,4,0,8 x 10 Tasveer,2009,
2274,21,4,17,0,99,2009,
2275,12,2,10,0,Aa Dekhen Zara,2009,
2276,11,2,9,0,Aadmi Ki Aurat Aur Anya Kahaniya,2009,
2277,16,4,12,0,Aagey Se Right,2009,
2278,12,5,7,0,Aao Wish Karein,2009,
2279,12,5,7,0,Acid Factory,2009,
2280,10,2,8,0,Agyaat,2009,
2281,27,5,22,0,Ajab Prem Ki Ghazab Kahani,2009,
2282,27,5,22,0,Aladin,2009,
2283,13,4,9,0,All the Best: Fun Begins,2009,
2284,13,5,8,0,Aloo Chaat,2009,
2285,23,5,18,0,Anjaneyulu,2009,
2286,79,20,59,0,Baabarr,2009,
2287,6,4,2,0,Barah Aana,2009,
2288,57,12,45,0,Billu,2009,
2289,10,3,7,0,Blue,2009,
2290,29,9,20,0,Blue Oranges,2009,
2291,7,3,4,0,Bollywood Hero,2009,
2292,31,8,23,0,Bolo Raam,2009,
2293,23,12,11,0,Bombay Summer,2009,
2294,10,3,7,0,Chal Chala Chal,2009,
2295,31,5,26,0,Chandni Chowk to China,2009,
2296,41,9,32,0,Chintu Ji,2009,
2297,84,28,56,0,City of Life,2009,
2298,33,15,18,0,Cooking with Stella,2009,
2299,18,5,13,0,Daddy Cool: Join the Fun,2009,
2300,19,8,11,0,De Dana Dan,2009,
2301,33,12,21,0,Delhi-6,2009,
2302,22,7,15,0,Detective Naani,2009,
2303,38,12,26,0,Dev.D,2009,
2304,25,4,21,0,Dhoondte Reh Jaoge,2009,
2305,27,6,21,0,Dil Bole Hadippa!,2009,
2306,13,5,8,0,Do Knot Disturb,2009,
2307,17,6,11,0,Dragonball Evolution,2009,
2308,29,5,24,0,Ek: The Power of One,2009,
2309,45,10,35,0,Fox,2009,
2310,17,2,15,0,Fruit & Nut,2009,
2311,4,2,2,0,"Gallit Gondhal, Dillit Mujra",2009,
2312,21,6,15,0,Gulaal,2009,
2313,11,3,8,0,Jai Veeru: Friends Forever,2009,
2314,74,6,68,0,Jail,2009,
2315,9,3,6,0,Jashnn: The Music Within,2009,
2316,13,3,10,0,Jugaad,2009,
2317,15,6,9,0,Kal Kissne Dekha,2009,
2318,32,18,14,0,Kambakkht Ishq,2009,
2319,73,17,56,0,Kaminey,2009,
2320,18,2,16,0,Kanthaswamy,2009,
2321,21,9,12,0,"Karma, Confessions and Holi",2009,
2322,11,2,9,0,Kisaan,2009,
2323,16,3,13,0,Kisse Pyaar Karoon?,2009,
2324,67,20,47,0,Kurbaan,2009,
2325,26,6,20,0,Kvelaferi kargad iqneba,2009,
2326,66,11,55,0,Laadli Laila,2009,
2327,54,30,24,0,Life Goes On,2009,
2328,32,11,21,0,London Dreams,2009,
2329,99,39,60,0,Love Aaj Kal,2009,
2330,22,11,11,0,Love Khichdi,2009,
2331,13,5,8,0,Luck,2009,
2332,51,23,28,0,Luck by Chance,2009,
2333,12,3,9,0,Madholal Keep Walking,2009,
2334,16,6,10,0,Madly Bangali,2009,
2335,18,7,11,0,Mahathma,2009,
2336,12,8,4,0,Main Aurr Mrs Khanna,2009,
2337,17,5,12,0,Maska,2009,
2338,8,4,4,0,Mere Khwabon Mein Jo Aaye,2009,
2339,5,2,3,0,Mohandas,2009,
2340,8,5,3,0,Morning Walk,2009,
2341,53,10,43,0,New York,2009,
2342,49,10,39,0,Paa,2009,
2343,13,5,8,0,Paying Guests,2009,
2344,27,8,19,0,Quick Gun Murugun: Misadventures of an Indian Cowboy,2009,
2345,11,6,5,0,"Raat Gayi, Baat Gayi?",2009,
2346,14,5,9,0,Raaz: The Mystery Continues,2009,
2347,21,10,11,0,Radio: Love on Air,2009,
2348,16,4,12,0,Red Alert: The War Within,2009,
2349,12,3,9,0,"Road, Movie",2009,
2350,32,4,28,0,Rocket Singh: Salesman of the Year,2009,
2351,9,2,7,0,Sanam Teri Kasam,2009,
2352,17,3,14,0,Sankat City,2009,
2353,24,5,19,0,Sankham,2009,
2354,18,6,12,0,Shadow,2009,
2355,19,5,14,0,Shortkut - The Con Is On,2009,
2356,16,3,13,0,Siddharth: The Prisoner,2009,
2357,16,1,15,0,Sikandar,2009,
2358,18,8,10,0,Straight,2009,
2359,29,12,17,0,Street Fighter: The Legend of Chun-Li,2009,
2360,34,6,28,0,Team: The Force,2009,
2361,11,2,9,0,Tera Kya Hoga Johnny,2009,
2362,5,3,2,0,Teree Sang: A Kidult Love Story,2009,
2363,38,12,26,0,Thanks Maa,2009,
2364,6,1,5,0,The Forest,2009,
2365,9,4,5,0,The President Is Coming,2009,
2366,48,9,39,0,The Stoneman Murders,2009,
2367,18,7,11,0,The Taste of Relation,2009,
2368,5,2,3,0,"Three: Love, Lies, Betrayal",2009,
2369,10,2,8,0,Tum Mile,2009,
2370,12,4,8,0,Vaada Raha... I Promise,2009,
2371,11,3,8,0,Veera Madakari,2009,
2372,21,5,16,0,Victory,2009,
2373,6,2,4,0,Vihir,2009,
2374,16,5,11,0,Villu,2009,
2375,14,7,7,0,Wake Up Sid,2009,
2376,42,5,37,0,Wanted,2009,
2377,48,13,35,0,Well Done Abba!,2009,
2378,41,12,29,0,What's Your Raashee?,2009,
2379,9,5,4,0,10ml LOVE,2010,
2380,19,8,11,0,A Flat,2010,
2381,15,2,13,0,Aakhari Decision,2010,
2382,20,5,15,0,Aakrosh,2010,
2383,22,10,12,0,Aashayein,2010,
2384,23,12,11,0,Accident on Hill Road,2010,
2385,9,4,5,0,Action Replayy,2010,
2386,22,7,15,0,Adhurs,2010,
2387,25,10,15,0,Aisha,2010,
2388,13,3,10,0,Allah Ke Banday,2010,
2389,33,10,23,0,Anjaana Anjaani,2010,
2390,30,17,13,0,Apartment: Rent at Your Own Risk,2010,
2391,21,2,19,0,Atithi Tum Kab Jaoge?,2010,
2392,28,10,18,0,Badmaa$h Company,2010,
2393,17,4,13,0,Band Baaja Baaraat,2010,
2394,15,8,7,0,Benny and Babloo,2010,
2395,49,5,44,0,Bhavnao Ko Samjho,2010,
2396,11,6,5,0,Break Ke Baad,2010,
2397,19,11,8,0,Bumm Bumm Bole,2010,
2398,18,3,15,0,Chance Pe Dance,2010,
2399,24,7,17,0,Chase,2010,
2400,39,7,32,0,City of Gold - Mumbai 1982: Ek Ankahee Kahani,2010,
2401,9,5,4,0,Click,2010,
2402,22,4,18,0,Crook: It's Good to Be Bad,2010,
2403,38,13,25,0,Daayen Ya Baayen,2010,
2404,37,8,29,0,Dabangg,2010,
2405,43,15,28,0,Dhobi Ghat,2010,
2406,71,25,46,0,Do Dooni Chaar,2010,
2407,14,6,8,0,Dulha Mil Gaya,2010,
2408,12,6,6,0,Dunno Y Na Jaane Kyun...,2010,
2409,22,9,13,0,Dus Tola,2010,
2410,18,7,11,0,Fired,2010,
2411,40,15,25,0,Get Educated: Paathshaala,2010,
2412,63,14,49,0,Golimar,2010,
2413,18,4,14,0,Golmaal 3,2010,
2414,51,20,31,0,Guzaarish,2010,
2415,10,4,6,0,Harud,2010,
2416,34,11,23,0,Hello Darling,2010,
2417,66,17,49,0,Hello Hum Lallann Bol Rahe Hain,2010,
2418,9,7,2,0,Help,2010,
2419,21,5,16,0,Hide & Seek,2010,
2420,11,4,7,0,Hisss,2010,
2421,42,11,31,0,Housefull,2010,
2422,22,6,16,0,Hum Tum Aur Ghost,2010,
2423,23,7,16,0,I Am,2010,
2424,8,4,4,0,I Am 24,2010,
2425,29,12,17,0,I Am Kalam,2010,
2426,16,7,9,0,I Hate Luv Storys,2010,
2427,10,4,6,0,Ishqiya,2010,
2428,31,13,18,0,Isi Life Mein...!,2010,
2429,37,17,20,0,Iti Mrinalini: An Unfinished Letter...,2010,
2430,27,16,11,0,Jaane Kahan Se Aayi Hai,2010,
2431,32,8,24,0,Jhootha Hi Sahi,2010,
2432,14,4,10,0,Kaalo,2010,
2433,15,7,8,0,Kajraare,2010,
2434,32,8,24,0,Karthik Calling Karthik,2010,
2435,18,4,14,0,Khaleja,2010,
2436,26,8,18,0,Khatta Meetha,2010,
2437,42,10,32,0,Khelein Hum Jee Jaan Sey,2010,
2438,16,5,11,0,Khichdi: The Movie,2010,
2439,15,6,9,0,Khuda Kasam,2010,
2440,9,3,6,0,Kiccha Huccha,2010,
2441,22,6,16,0,Kites,2010,
2442,32,8,24,0,Knock Out,2010,
2443,17,4,13,0,Kushti,2010,
2444,33,11,22,0,"LSD: Love, Sex Aur Dhokha",2010,
2445,16,4,12,0,Lafangey Parindey,2010,
2446,66,11,55,0,Lahore,2010,
2447,30,6,24,0,Lamhaa: The Untold Story of Kashmir,2010,
2448,6,5,1,0,Mee Sindhutai Sapkal,2010,
2449,17,6,11,0,Memories in March,2010,
2450,14,6,8,0,Milenge Milenge,2010,
2451,10,4,6,0,Mirch,2010,
2452,3,1,2,0,Mr. Singh/Mrs. Mehta,2010,
2453,13,5,8,0,Mr. Theertha,2010,
2454,186,70,116,0,My Name Is Khan,2010,
2455,46,15,31,0,Na Ghar Ke Na Ghaat Ke,2010,
2456,37,10,27,0,Namo Venkatesha,2010,
2457,28,7,21,0,No Problem,2010,
2458,53,10,43,0,Once Upon a Time in Mumbaai,2010,
2459,7,2,5,0,Pairon Talle,2010,
2460,19,7,12,0,Panchakshari,2010,
2461,11,4,7,0,Pankh,2010,
2462,13,4,9,0,Pappu Can't Dance Saala,2010,
2463,30,6,24,0,Payback,2010,
2464,16,4,12,0,Peepli Live,2010,
2465,41,17,24,0,Phas Gaye Re Obama,2010,
2466,12,5,7,0,Phoonk 2,2010,
2467,13,6,7,0,Prem Kaa Game,2010,
2468,10,3,7,0,Prince,2010,
2469,23,7,16,0,Pusher,2010,
2470,11,5,6,0,Pyaar Impossible!,2010,
2471,19,4,15,0,Raajneeti,2010,
2472,14,4,10,0,Raavan,2010,
2473,31,8,23,0,Rakhta Charitra,2010,
2474,20,4,16,0,Rakhta Charitra 2,2010,
2475,14,5,9,0,Ramaa: The Saviour,2010,
2476,4,1,3,0,Ramayana: The Epic,2010,
2477,17,6,11,0,Rann,2010,
2478,20,6,14,0,Right Yaaa Wrong,2010,
2479,82,11,71,0,Road to Sangam,2010,
2480,15,8,7,0,Rokkk,2010,
2481,22,9,13,0,Sadiyaan: Boundaries Divide... Love Unites,2010,
2482,21,4,17,0,Seetharamula Kalyanam Lankalo,2010,
2483,19,6,13,0,Shaapit: The Cursed,2010,
2484,7,2,5,0,Shahrukh Bola 'Khoobsurat Hai Tu'... And She Believed in It,2010,
2485,11,3,8,0,Shor in the City,2010,
2486,33,4,29,0,Soch Lo,2010,
2487,161,12,149,0,Striker,2010,
2488,23,6,17,0,Teen Patti,2010,
2489,27,4,23,0,Tees Maar Khan,2010,
2490,18,2,16,0,Tere Bin Laden,2010,
2491,16,3,13,0,That Girl in Yellow Boots,2010,
2492,15,3,12,0,The Film Emotional Atyachar,2010,
2493,3,1,2,0,The Untitled Kartik Krishnan Project,2010,
2494,13,4,9,0,The Waiting Room,2010,
2495,11,5,6,0,Toh Baat Pakki!,2010,
2496,13,4,9,0,Toonpur Ka Superrhero,2010,
2497,53,14,39,0,Tum Milo Toh Sahi,2010,
2498,43,8,35,0,Udaan,2010,
2499,25,5,20,0,Varudu,2010,
2500,35,11,24,0,Veer,2010,
2501,11,3,8,0,Veera Parampare,2010,
2502,34,15,19,0,Walkaway,2010,
2503,9,6,3,0,We Are Family,2010,
2504,14,4,10,0,404: Error Not Found,2011,
2505,15,6,9,0,7 Aum Arivu,2011,
2506,20,4,16,0,7 Khoon Maaf,2011,
2507,22,6,16,0,Aarakshan,2011,
2508,11,5,6,0,Aashiqui.in,2011,
2509,17,5,12,0,Aazaan,2011,
2510,12,4,8,0,Always Kabhi Kabhi,2011,
2511,24,9,15,0,Angel,2011,
2512,22,6,16,0,Badrinath,2011,
2513,14,3,11,0,Bbuddah... Hoga Terra Baap,2011,
2514,20,7,13,0,Be-Careful,2011,
2515,14,2,12,0,Bezawada,2011,
2516,12,4,8,0,Bheja Fry 2,2011,
2517,15,5,10,0,Bhindi Baazaar,2011,
2518,20,6,14,0,Bin Bulaye Baraati,2011,
2519,32,12,20,0,Bodyguard,2011,
2520,36,14,22,0,Bol,2011,
2521,8,2,6,0,Bubble Gum,2011,
2522,9,2,7,0,Chala Mussaddi - Office Office,2011,
2523,12,1,11,0,Chalo Dilli,2011,
2524,9,3,6,0,Chargesheet,2011,
2525,19,3,16,0,Chatur Singh Two Star,2011,
2526,56,16,40,0,Chillar Party,2011,
2527,39,16,23,0,Chitkabrey,2011,
2528,22,9,13,0,Curry Munchers,2011,
2529,17,4,13,0,Cycle Kick,2011,
2530,14,4,10,0,Dam999,2011,
2531,13,6,7,0,Damadamm!,2011,
2532,62,18,44,0,Delhi Belly,2011,
2533,8,2,6,0,Delhi in a Day,2011,
2534,60,23,37,0,Desi Boyz,2011,
2535,8,2,6,0,Dharti,2011,
2536,27,11,16,0,Dil Toh Baccha Hai Ji,2011,
2537,43,7,36,0,Don 2,2011,
2538,16,2,14,0,Double Dhamaal,2011,
2539,54,12,42,0,Dum Maaro Dum,2011,
2540,22,5,17,0,F.A.L.T.U,2011,
2541,20,4,16,0,Force,2011,
2542,65,34,31,0,French Immersion,2011,
2543,15,4,11,0,Game,2011,
2544,54,15,39,0,Gandhi to Hitler,2011,
2545,31,5,26,0,Gattu,2011,
2546,10,5,5,0,Haunted - 3D,2011,
2547,32,4,28,0,Hostel,2011,
2548,15,5,10,0,Hum Tum Shabana,2011,
2549,63,18,45,0,I Am Singh,2011,
2550,17,7,10,0,Impatient Vivek,2011,
2551,67,12,55,0,Jo Dooba So Paar: It's Love in Bihar!,2011,
2552,10,3,7,0,Jo Hum Chahein,2011,
2553,10,4,6,0,Kaccha Limboo,2011,
2554,20,6,14,0,Kempe Gowda,2011,
2555,13,4,9,0,Khap,2011,
2556,11,3,8,0,Kshay,2011,
2557,7,2,5,0,Kucch Luv Jaisaa,2011,
2558,7,4,3,0,Ladies vs. Ricky Bahl,2011,
2559,9,2,7,0,Lanka,2011,
2560,14,4,10,0,Loot,2011,
2561,17,8,9,0,Love Breakups Zindagi,2011,
2562,25,16,9,0,Love Express,2011,
2563,11,3,8,0,Love U... Mr. Kalakaar!,2011,
2564,12,5,7,0,Lucky,2011,
2565,28,14,14,0,Luv Ka the End,2011,
2566,15,2,13,0,Masti Express,2011,
2567,19,8,11,0,Mausam,2011,
2568,51,23,28,0,Mere Brother Ki Dulhan,2011,
2569,7,4,3,0,Michael,2011,
2570,12,5,7,0,Miley - Naa Miley - Hum,2011,
2571,20,6,14,0,Mod,2011,
2572,39,9,30,0,Monica,2011,
2573,12,6,6,0,Mujhse Fraaandship Karoge,2011,
2574,31,10,21,0,Murder 2,2011,
2575,36,8,28,0,My Friend Pinto,2011,
2576,22,9,13,0,Naughty @ 40,2011,
2577,24,9,15,0,No One Killed Jessica,2011,
2578,12,5,7,0,Not a Love Story,2011,
2579,7,3,4,0,Noukadubi,2011,
2580,9,3,6,0,Patang,2011,
2581,38,12,26,0,Patiala House,2011,
2582,10,5,5,0,Phhir,2011,
2583,9,3,6,0,Pyaar Ka Punchnama,2011,
2584,45,11,34,0,Ra.One,2011,
2585,7,4,3,0,Ragini MMS,2011,
2586,15,3,12,0,Rascals,2011,
2587,39,13,26,0,Ready,2011,
2588,22,8,14,0,Rockstar,2011,
2589,9,2,7,0,Sadda Adda,2011,
2590,37,8,29,0,Saheb Biwi Aur Gangster,2011,
2591,13,4,9,0,Sahi Dhandhe Galat Bande,2011,
2592,38,6,32,0,Satrangee Parachute,2011,
2593,17,3,14,0,Shabri,2011,
2594,16,3,13,0,Shagird,2011,
2595,18,6,12,0,Shaitan,2011,
2596,29,8,21,0,Shuttlecock Boys,2011,
2597,26,6,20,0,Singham,2011,
2598,26,12,14,0,Soundtrack,2011,
2599,17,2,15,0,Stanley Ka Dabba,2011,
2600,13,4,9,0,Tanu Weds Manu,2011,
2601,6,1,5,0,Teen Thay Bhai,2011,
2602,19,7,12,0,Tell Me O Kkhuda,2011,
2603,22,10,12,0,Tere Mere Phere,2011,
2604,24,15,9,0,Thank You,2011,
2605,58,18,40,0,The Best Exotic Marigold Hotel,2011,
2606,15,6,9,0,The Dirty Picture,2011,
2607,12,6,6,0,The Train,2011,
2608,28,13,15,0,Trishna,2011,
2609,45,21,24,0,Turning 30!!!,2011,
2610,14,6,8,0,U R My Jaan,2011,
2611,13,3,10,0,Utt Pataang,2011,
2612,11,5,6,0,Vedi,2011,
2613,8,0,8,0,Veettilekkulla Vazhi,2011,
2614,13,4,9,0,Vishnuvardhana,2011,
2615,20,6,14,0,Yamla Pagla Deewana,2011,
2616,13,6,7,0,Yeh Dooriyan,2011,
2617,16,3,13,0,Yeh Saali Zindagi,2011,
2618,34,14,20,0,Zindagi Na Milegi Dobara,2011,
2619,11,5,6,0,Zokkomon,2011,
2620,7,3,4,0,100% Love,2012,
2621,7,3,4,0,1920: Evil Returns,2012,
2622,8,5,3,0,3 Bachelors,2012,
2623,7,2,5,0,5 Ghantey Mien 5 Crore,2012,
2624,30,6,24,0,7 Welcome to London,2012,
2625,6,2,4,0,?: A Question Mark,2012,
2626,23,6,17,0,Agent Vinod,2012,
2627,23,9,14,0,Agneepath,2012,
2628,30,9,21,0,Aiyyaa,2012,
2629,9,3,6,0,Ajab Gazabb Love,2012,
2630,26,2,24,0,Arjun: The Warrior Prince,2012,
2631,29,2,27,0,Ata Pata Lapatta,2012,
2632,13,6,7,0,B.A. Pass,2012,
2633,26,11,15,0,Barfi!,2012,
2634,5,3,2,0,Bhoot Returns,2012,
2635,8,2,6,0,Bittoo Boss,2012,
2636,6,2,4,0,Blood Money,2012,
2637,10,5,5,0,Bol Bachchan,2012,
2638,9,1,8,0,Bumboo,2012,
2639,10,3,7,0,Chaalis Chauraasi,2012,
2640,21,5,16,0,Chaar Din Ki Chandni,2012,
2641,15,2,13,0,Chakravyuh,2012,
2642,15,5,10,0,Challo Driver,2012,
2643,14,4,10,0,Chhodo Kal Ki Baatein,2012,
2644,9,2,7,0,Chhota Bheem and the Curse of Damyaan,2012,
2645,38,6,32,0,Chittagong,2012,
2646,90,29,61,0,Cocktail,2012,
2647,20,5,15,0,Daal Mein Kuch Kaala Hai,2012,
2648,25,7,18,0,Dabangg 2,2012,
2649,9,3,6,0,Dangerous Ishhq,2012,
2650,30,8,22,0,Delhi Safari,2012,
2651,10,5,5,0,Department,2012,
2652,8,3,5,0,Diary of a Butterfly,2012,
2653,9,1,8,0,Edegarike,2012,
2654,16,3,13,0,Eega,2012,
2655,27,12,15,0,Ek Main Aur Ekk Tu,2012,
2656,33,6,27,0,Ek Tha Tiger,2012,
2657,13,6,7,0,Ekk Deewana Tha,2012,
2658,46,19,27,0,English Vinglish,2012,
2659,10,3,7,0,Fatso!,2012,
2660,18,4,14,0,Ferrari Ki Sawaari,2012,
2661,5,0,5,0,Filmistaan,2012,
2662,13,7,6,0,From Sydney with Love,2012,
2663,13,5,8,0,Future to Bright Hai Ji,2012,
2664,19,3,16,0,Gali Gali Chor Hai,2012,
2665,25,5,20,0,Gangs of Wasseypur,2012,
2666,11,3,8,0,Ghost,2012,
2667,20,7,13,0,Hate Story,2012,
2668,25,14,11,0,Heroine,2012,
2669,29,11,18,0,Housefull 2,2012,
2670,37,12,25,0,I.D.,2012,
2671,20,6,14,0,Ishaqzaade,2012,
2672,107,42,65,0,Jab Tak Hai Jaan,2012,
2673,8,3,5,0,Jalpari: The Desert Mermaid,2012,
2674,12,1,11,0,Jannat 2,2012,
2675,6,1,5,0,Jism 2,2012,
2676,11,6,5,0,Jodi Breakers,2012,
2677,22,8,14,0,Joker,2012,
2678,40,8,32,0,Kahaani,2012,
2679,9,4,5,0,Kaksparsh,2012,
2680,10,3,7,0,Kamaal Dhamaal Malamaal,2012,
2681,16,3,13,0,Kevi Rite Jaish,2012,
2682,22,3,19,0,Khiladi 786,2012,
2683,11,4,7,0,Khokababu,2012,
2684,18,3,15,0,Kismet Love Paisa Dilli,2012,
2685,25,11,14,0,Krishna Aur Kans,2012,
2686,16,4,12,0,Kyaa Super Kool Hain Hum,2012,
2687,22,7,15,0,Le Halua Le,2012,
2688,19,1,18,0,Life Ki Toh Lag Gayi,2012,
2689,42,13,29,0,Life of Pi,2012,
2690,29,9,20,0,Life! Camera Action...,2012,
2691,15,4,11,0,Login,2012,
2692,23,10,13,0,London Paris New York,2012,
2693,29,11,18,0,Luv Shuv Tey Chicken Khurana,2012,
2694,16,4,12,0,Luv U Soniyo,2012,
2695,8,2,6,0,Maharana Pratap: The First Freedom Fighter,2012,
2696,9,3,6,0,Maximum,2012,
2697,16,4,12,0,Mere Dost Picture Abhi Baaki Hai,2012,
2698,100,26,74,0,Midnight's Children,2012,
2699,112,34,78,0,Miss Lovely,2012,
2700,14,7,7,0,Mr Bhatti on Chutti,2012,
2701,5,0,5,0,Mumbai Cha Raja,2012,
2702,37,11,26,0,OMG: Oh My God!,2012,
2703,18,9,9,0,Oass,2012,
2704,15,2,13,0,Paan Singh Tomar,2012,
2705,7,2,5,0,Peddlers,2012,
2706,16,4,12,0,Players,2012,
2707,4,2,2,0,Raaz 3: The Third Dimension,2012,
2708,28,10,18,0,Rowdy Rathore,2012,
2709,9,3,6,0,Rush,2012,
2710,17,3,14,0,Shahid,2012,
2711,14,4,10,0,Shanghai,2012,
2712,77,26,51,0,Ship of Theseus,2012,
2713,9,5,4,0,Shirin Farhad Ki Toh Nikal Padi,2012,
2714,20,4,16,0,Shudra the Rising,2012,
2715,13,3,10,0,Son of Sardaar,2012,
2716,4,0,4,0,Sons of Ram,2012,
2717,25,12,13,0,Student of the Year,2012,
2718,80,27,53,0,Talaash,2012,
2719,9,5,4,0,Tere Naal Love Ho Gaya,2012,
2720,13,3,10,0,Teri Meri Kahaani,2012,
2721,26,8,18,0,Testing Movie,2012,
2722,98,30,68,0,Tezz,2012,
2723,48,12,36,0,Thaandavam,2012,
2724,126,39,87,0,The Avengers,2012,
2725,50,19,31,0,The Domino Effect,2012,
2726,22,5,17,0,Thuppakki,2012,
2727,13,5,8,0,Vicky Donor,2012,
2728,7,3,4,0,Will You Marry Me,2012,
2729,8,5,3,0,Yeh Jo Mohabbat Hai,2012,
2730,15,8,7,0,3G - A Killer Connection,2013,
2731,51,13,38,0,A Good Day to Die Hard,2013,
2732,7,3,4,0,A New Love Ishtory,2013,
2733,13,3,10,0,ABCD Any Body Can Dance,2013,
2734,9,4,5,0,Aadhi Bhagavan,2013,
2735,13,2,11,0,Aashiqui 2,2013,
2736,12,5,7,0,Aatma,2013,
2737,7,3,4,0,Akaash Vani,2013,
2738,32,7,25,0,Ankhon Dekhi,2013,
2739,10,4,6,0,Ankur Arora Murder Case,2013,
2740,16,6,10,0,Attahaasa,2013,
2741,14,7,7,0,Aurangzeb,2013,
2742,6,2,4,0,Baat Bann Gayi,2013,
2743,30,9,21,0,Bachchan,2013,
2744,15,7,8,0,Bajatey Raho,2013,
2745,4,1,3,0,Bandook,2013,
2746,8,3,5,0,Besharam,2013,
2747,34,7,27,0,Bhaag Milkha Bhaag,2013,
2748,30,10,20,0,Bombay Talkies,2013,
2749,23,4,19,0,Boss,2013,
2750,15,2,13,0,Bullett Raja,2013,
2751,9,3,6,0,Chashme Baddoor,2013,
2752,8,2,6,0,Chennai Express,2013,
2753,3,0,3,0,Chhota Bheem and the Throne of Bali,2013,
2754,15,2,13,0,Chor chor super chor,2013,
2755,14,8,6,0,Club 60,2013,
2756,38,7,31,0,Commando,2013,
2757,69,10,59,0,D-Day,2013,
2758,37,13,24,0,Dabba,2013,
2759,26,10,16,0,David,2013,
2760,12,3,9,0,Deewana Main Deewana,2013,
2761,102,45,57,0,Dhoom:3,2013,
2762,6,2,4,0,Dracula 2012,2013,
2763,30,14,16,0,Ek Thi Daayan,2013,
2764,14,3,11,0,Enemmy,2013,
2765,40,11,29,0,Fukrey,2013,
2766,10,6,4,0,Gangoobai,2013,
2767,12,3,9,0,Ghanchakkar,2013,
2768,33,20,13,0,Gippi,2013,
2769,7,2,5,0,Go Goa Gone,2013,
2770,50,11,39,0,Goliyon Ki Rasleela Ram-Leela,2013,
2771,3,0,3,0,Goopi Gawaiya Bagha Bajaiya,2013,
2772,12,7,5,0,Gori Tere Pyaar Mein!,2013,
2773,11,6,5,0,Grand Masti,2013,
2774,17,8,9,0,Himmatwala,2013,
2775,12,6,6,0,Horror Story,2013,
2776,9,3,6,0,Hum Hai Raahi CAR Ke,2013,
2777,17,9,8,0,"I, Me aur Main",2013,
2778,17,5,12,0,Inkaar,2013,
2779,8,2,6,0,Irandam Ulagam,2013,
2780,5,3,2,0,Ishk Actually,2013,
2781,10,5,5,0,Ishkq in Paris,2013,
2782,25,4,21,0,Issaq,2013,
2783,19,3,16,0,Jackpot,2013,
2784,21,5,16,0,Jal,2013,
2785,6,1,5,0,Jayantabhai Ki Luv Story,2013,
2786,17,3,14,0,John Day,2013,
2787,16,3,13,0,Jolly LLB,2013,
2788,6,0,6,0,Kaafiron Ki Namaaz,2013,
2789,16,3,13,0,Kai po che!,2013,
2790,16,1,15,0,Kajarya,2013,
2791,46,17,29,0,Krrish 3,2013,
2792,5,0,5,0,Lakeer Ka Fakeer,2013,
2793,11,3,8,0,Lateef,2013,
2794,5,2,3,0,Liar's Dice,2013,
2795,20,9,11,0,Listen... Amaya,2013,
2796,23,3,20,0,Lootera,2013,
2797,14,2,12,0,Maazii,2013,
2798,20,4,16,0,Madras Cafe,2013,
2799,9,2,7,0,Mahabharat,2013,
2800,5,3,2,0,Mai,2013,
2801,21,6,15,0,Main Krishna Hoon,2013,
2802,4,3,1,0,Mangalashtak Once More,2013,
2803,9,3,6,0,Mastram,2013,
2804,11,3,8,0,Matru ki Bijlee ka Mandola,2013,
2805,11,5,6,0,Mere Dad Ki Maruti,2013,
2806,13,2,11,0,Meridian Lines,2013,
2807,10,2,8,0,Mickey Virus,2013,
2808,37,11,26,0,Monsoon Shootout,2013,
2809,12,2,10,0,Mumbai Mirror,2013,
2810,6,3,3,0,Murder 3,2013,
2811,13,3,10,0,Nasha,2013,
2812,27,5,22,0,Nautanki Saala!,2013,
2813,37,17,20,0,Not Today,2013,
2814,68,15,53,0,Once Upon a Time in Mumbai Dobaara!,2013,
2815,20,6,14,0,Ooops a Desi,2013,
2816,4,1,3,0,Pattathu Yaanai,2013,
2817,22,3,19,0,Phata Poster Nikhla Hero,2013,
2818,7,2,5,0,Phoring,2013,
2819,18,3,15,0,Policegiri,2013,
2820,7,3,4,0,Prague,2013,
2821,30,13,17,0,Queen,2013,
2822,17,6,11,0,R... Rajkumar,2013,
2823,22,8,14,0,Raanjhanaa,2013,
2824,14,8,6,0,Rabba Main Kya Karoon,2013,
2825,18,5,13,0,Race 2,2013,
2826,14,4,10,0,Rajdhani Express,2013,
2827,39,11,28,0,Rajjo,2013,
2828,12,4,8,0,Ramaiya Vastavaiya,2013,
2829,15,5,10,0,Rangrezz,2013,
2830,17,4,13,0,Rise of the Zombie,2013,
2831,8,1,7,0,Saare Jahaan Se Mehnga...,2013,
2832,8,1,7,0,Sahasam,2013,
2833,11,3,8,0,Saheb Biwi Aur Gangster Returns,2013,
2834,9,2,7,0,Satya 2,2013,
2835,18,6,12,0,Satyagraha,2013,
2836,31,7,24,0,Shootout at Wadala,2013,
2837,13,4,9,0,Shortcut Romeo,2013,
2838,11,5,6,0,Shorts,2013,
2839,19,3,16,0,Shree,2013,
2840,31,8,23,0,Shuddh Desi Romance,2013,
2841,66,14,52,0,Siddharth,2013,
2842,37,11,26,0,Singam 2,2013,
2843,20,4,16,0,Singh Saab the Great,2013,
2844,18,7,11,0,Sixteen,2013,
2845,11,5,6,0,Sona Spa,2013,
2846,8,1,7,0,Sooper Se Ooper,2013,
2847,86,12,74,0,Special Chabbis,2013,
2848,22,9,13,0,Sri Siddhartha Gautama,2013,
2849,23,9,14,0,Super Model,2013,
2850,25,6,19,0,Table No.21,2013,
2851,18,1,17,0,The Attacks of 26/11,2013,
2852,7,3,4,0,The Good Road,2013,
2853,52,13,39,0,The Lovers,2013,
2854,45,10,35,0,Ugly,2013,
2855,13,4,9,0,Vakratunda Mahakaaya,2013,
2856,18,5,13,0,Varadanayaka,2013,
2857,16,3,13,0,Vishwaroopam,2013,
2858,9,2,7,0,War Chod Na Yaar,2013,
2859,9,3,6,0,Warning,2013,
2860,11,4,7,0,What the Fish,2013,
2861,130,42,88,0,Yamla Pagla Deewana 2,2013,
2862,33,17,16,0,Yeh Jawaani Hai Deewani,2013,
2863,19,5,14,0,Zanjeer,2013,
2864,25,7,18,0,Zila Ghaziabad,2013,
2865,10,4,6,0,Zindagi 50 50,2013,
2866,11,4,7,0,2 States,2014,
2867,4,1,3,0,3 AM: A Paranormal Experience,2014,
2868,7,2,5,0,6-5=2,2014,
2869,21,4,17,0,Action Jackson,2014,
2870,27,19,8,0,Amit Sahni Ki List,2014,
2871,21,4,17,0,Anjaan,2014,
2872,6,3,3,0,Babloo Happy Hai,2014,
2873,7,2,5,0,Badlapur Boys,2014,
2874,23,5,18,0,Bang Bang,2014,
2875,6,3,3,0,Bewakoofiyaan,2014,
2876,41,11,30,0,Bhoothnath Returns,2014,
2877,25,6,19,0,Bhopal: A Prayer for Rain,2014,
2878,29,9,20,0,Bing feng: Chong sheng zhi men,2014,
2879,52,24,28,0,Bobby Jasoos,2014,
2880,2,0,2,0,Chaar Sahibzaade,2014,
2881,25,3,22,0,Chal Bhaag,2014,
2882,10,4,6,0,Chauranga,2014,
2883,28,6,22,0,Children of War,2014,
2884,11,4,7,0,City Lights,2014,
2885,11,6,5,0,Court,2014,
2886,8,2,6,0,Creature,2014,
2887,78,26,52,0,Daawat-e-Ishq,2014,
2888,16,6,10,0,Darr @ the Mall,2014,
2889,7,2,5,0,Dedh Ishqiya,2014,
2890,11,2,9,0,Dekh Tamasha Dekh,2014,
2891,12,3,9,0,Desi Kattey,2014,
2892,11,2,9,0,Dishkiyaoon,2014,
2893,15,8,7,0,Ek Villain,2014,
2894,13,4,9,0,Ekkees Toppon Ki Salaami,2014,
2895,33,13,20,0,Finding Fanny,2014,
2896,15,5,10,0,Fugly,2014,
2897,13,3,10,0,Gang of Ghosts,2014,
2898,38,11,27,0,Gollu aur Pappu,2014,
2899,9,6,3,0,Gulaab Gang,2014,
2900,15,1,14,0,Gunday,2014,
2901,16,2,14,0,Haider,2014,
2902,31,15,16,0,Happy Ending,2014,
2903,29,7,22,0,Happy New Year,2014,
2904,79,26,53,0,Hasee Toh Phasee,2014,
2905,23,6,17,0,Hate Story 2,2014,
2906,30,14,16,0,Hawaa Hawaai,2014,
2907,5,2,3,0,Heartless,2014,
2908,21,6,15,0,Heropanti,2014,
2909,66,18,48,0,Highway,2014,
2910,22,6,16,0,Holiday,2014,
2911,38,9,29,0,Humpty Sharma Ki Dulhania,2014,
2912,69,12,57,0,Humshakals,2014,
2913,29,13,16,0,I Origins,2014,
2914,20,4,16,0,Identity Card,2014,
2915,21,4,17,0,It's Entertainment,2014,
2916,35,10,25,0,Jai Ho,2014,
2917,10,5,5,0,Jigariyaa,2014,
2918,32,10,22,0,Jilla,2014,
2919,12,4,8,0,Kaanchi,2014,
2920,10,1,9,0,Karle Pyaar Karle,2014,
2921,15,5,10,0,Khoobsurat,2014,
2922,12,3,9,0,Khwaabb,2014,
2923,20,6,14,0,Kick,2014,
2924,10,1,9,0,Kill Dil,2014,
2925,12,3,9,0,Kochadaiiyaan,2014,
2926,9,2,7,0,Koyelaanchal,2014,
2927,6,3,3,0,Kuku Mathur Ki Jhand Ho Gayi,2014,
2928,3,0,3,0,Kya Dilli Kya Lahore,2014,
2929,7,5,2,0,Lakshmi,2014,
2930,16,7,9,0,Lekar Hum Deewana Dil,2014,
2931,21,2,19,0,Little Terrors,2014,
2932,7,2,5,0,Lucky Kabootar,2014,
2933,16,7,9,0,M.A.D: Mad About Dance,2014,
2934,33,12,21,0,Maanikya,2014,
2935,14,4,10,0,Machhli Jal Ki Rani Hai,2014,
2936,9,4,5,0,Main Aur Mr. Riight,2014,
2937,19,5,14,0,Main Tera Hero,2014,
2938,19,3,16,0,Manjunath,2014,
2939,19,4,15,0,Mardaani,2014,
2940,26,9,17,0,Margarita with a Straw,2014,
2941,14,4,10,0,Mary Kom,2014,
2942,15,1,14,0,Masala Republic,2014,
2943,111,30,81,0,Million Dollar Arm,2014,
2944,15,4,11,0,Mr Joe B. Carvalho,2014,
2945,6,3,3,0,Mumbai 125 KM 3D,2014,
2946,2,1,1,0,Mumbai Delhi Mumbai,2014,
2947,36,4,32,0,Myeong-ryang,2014,
2948,5,2,3,0,Nanak Shah Fakir,2014,
2949,13,5,8,0,O Teri,2014,
2950,16,6,10,0,One by Two,2014,
2951,9,4,5,0,Oraalppokkam,2014,
2952,27,8,19,0,PK,2014,
2953,7,2,5,0,Paranthe Wali Gali,2014,
2954,16,5,11,0,Pizza,2014,
2955,51,10,41,0,Punjab 1984,2014,
2956,14,6,8,0,Purani Jeans,2014,
2957,10,3,7,0,ROAR: Tigers of the Sundarbans,2014,
2958,28,13,15,0,Ragini MMS 2,2014,
2959,11,2,9,0,Raja Natwarlal,2014,
2960,9,2,7,0,Revolver Rani,2014,
2961,21,7,14,0,Samrat & Co.,2014,
2962,8,4,4,0,Shaadi Ke Side Effects,2014,
2963,42,6,36,0,Shuruaat Ka Interval,2014,
2964,22,3,19,0,Sin-ui hansu,2014,
2965,27,8,19,0,Singham Returns,2014,
2966,6,2,4,0,Sonali Cable,2014,
2967,9,2,7,0,Station,2014,
2968,9,3,6,0,Sulemani Keeda,2014,
2969,22,7,15,0,Sultanat,2014,
2970,10,7,3,0,Super Nani,2014,
2971,32,7,25,0,Surkhaab,2014,
2972,10,1,9,0,Tamanchey: Pyar Mein Dil Pe Maar De Goli,2014,
2973,16,8,8,0,The Hero of Color City,2014,
2974,40,13,27,0,The Hundred-Foot Journey,2014,
2975,18,8,10,0,The Shaukeens,2014,
2976,13,6,7,0,The Xpose,2014,
2977,23,6,17,0,Tigers,2014,
2978,23,7,16,0,Titli,2014,
2979,13,8,5,0,Titoo MBA,2014,
2980,28,7,21,0,Total Siyapaa,2014,
2981,8,3,5,0,Trip to Bhangarh: Asia's Most Haunted Place,2014,
2982,44,12,32,0,Unfreedom,2014,
2983,19,5,14,0,Ungli,2014,
2984,21,5,16,0,Ya Rab,2014,
2985,14,2,12,0,Yaan,2014,
2986,15,8,7,0,Yaariyan,2014,
2987,10,3,7,0,Yeh Hai Bakrapur,2014,
2988,23,7,16,0,Yevadu,2014,
2989,9,3,6,0,Youngistaan,2014,
2990,13,3,10,0,Zed Plus,2014,
2991,7,3,4,0,Zid,2014,
2992,14,3,11,0,31st October,2015,
2993,16,1,15,0,Ab Tak Chhappan 2,2015,
2994,14,3,11,0,Aligarh,2015,
2995,10,2,8,0,All Is Well,2015,
2996,9,6,3,0,Alone,2015,
2997,12,6,6,0,Angry Indian Goddesses,2015,
2998,40,19,21,0,Any Body Can Dance 2,2015,
2999,10,2,8,0,Baankey Ki Crazy Baraat,2015,
3000,19,3,16,0,Baby,2015,
3001,15,6,9,0,Badlapur,2015,
3002,5,2,3,0,Badmashiyaan,2015,
3003,22,9,13,0,Bahubali: The Beginning,2015,
3004,41,11,30,0,Bajirao Mastani,2015,
3005,121,20,101,0,Bajrangi Bhaijaan,2015,
3006,28,6,22,0,Bangistan,2015,
3007,10,3,7,0,Barefoot to Goa,2015,
3008,7,3,4,0,Barkhaa,2015,
3009,25,9,16,0,Bezubaan Ishq,2015,
3010,13,6,7,0,Bhaag Johnny,2015,
3011,71,22,49,0,Bombay Velvet,2015,
3012,45,9,36,0,Brothers,2015,
3013,21,7,14,0,Calendar Girls,2015,
3014,11,4,7,0,Charlie Kay Chakkar Mein,2015,
3015,6,2,4,0,Chinar Daastaan-E-Ishq,2015,
3016,5,3,2,0,Coffee Bloom,2015,
3017,19,5,14,0,De surprise,2015,
3018,24,4,20,0,Detective Byomkesh Bakshy!,2015,
3019,26,6,20,0,Dhanak,2015,
3020,9,4,5,0,Dharam Sankat Mein,2015,
3021,36,12,24,0,Dil Dhadakne Do,2015,
3022,7,3,4,0,Dilliwaali Zaalim Girlfriend,2015,
3023,33,5,28,0,Dilwale,2015,
3024,8,1,7,0,Dirty Politics,2015,
3025,11,3,8,0,Dolly Ki Doli,2015,
3026,58,11,47,0,Drishyam,2015,
3027,43,14,29,0,Dum Laga Ke Haisha,2015,
3028,31,10,21,0,Ek Paheli Leela,2015,
3029,22,8,14,0,Gabbar is Back,2015,
3030,32,7,25,0,Gour Hari Dastaan: The Freedom File,2015,
3031,5,3,2,0,Guddu Ki Gun,2015,
3032,12,1,11,0,Guddu Rangeela,2015,
3033,15,7,8,0,Halla Gulla,2015,
3034,14,5,9,0,Hamari Adhuri Kahani,2015,
3035,6,2,4,0,Haraamkhor,2015,
3036,8,3,5,0,Hate Story 3,2015,
3037,10,4,6,0,Hawaizaada,2015,
3038,12,3,9,0,Hero,2015,
3039,14,2,12,0,Hey Bro,2015,
3040,18,12,6,0,Hunterrr,2015,
3041,10,5,5,0,I Love New Year,2015,
3042,4,1,3,0,Ishqedarriyaan,2015,
3043,20,7,13,0,Island City,2015,
3044,9,3,6,0,Jaanisaar,2015,
3045,23,9,14,0,Jazbaa,2015,
3046,7,2,5,0,Kaagaz Ke Fools,2015,
3047,10,3,7,0,Katti Batti,2015,
3048,12,4,8,0,Kaun Kitney Paani Mein,2015,
3049,6,2,4,0,Khamoshiyan,2015,
3050,4,0,4,0,Khoya,2015,
3051,14,6,8,0,Kis Kisko Pyaar Karoon,2015,
3052,17,5,12,0,Kuch Kuch Locha Hai,2015,
3053,10,2,8,0,Loev,2015,
3054,13,8,5,0,Luv U Alia,2015,
3055,8,1,7,0,MSG 2 the Messenger,2015,
3056,7,3,4,0,MSG: The Messenger of God,2015,
3057,34,10,24,0,Main Aur Charles,2015,
3058,45,11,34,0,Manjhi: The Mountain Man,2015,
3059,28,11,17,0,Marry Me - Aber bitte auf Indisch,2015,
3060,60,11,49,0,Masaan,2015,
3061,21,5,16,0,Meeruthiya Gangsters,2015,
3062,6,1,5,0,Miss Tanakpur Haazir Ho,2015,
3063,7,2,5,0,Mohalla Assi,2015,
3064,6,1,5,0,Monsoon,2015,
3065,13,3,10,0,Mr. X,2015,
3066,28,5,23,0,Mrs. Scooter,2015,
3067,16,4,12,0,NH10,2015,
3068,9,4,5,0,Nil Battey Sannata,2015,
3069,6,1,5,0,Once Upon a Time in Bihar,2015,
3070,20,4,16,0,P Se PM Tak,2015,
3071,37,16,21,0,Parched,2015,
3072,97,40,57,0,Phantom,2015,
3073,33,11,22,0,Piku,2015,
3074,123,39,84,0,Pixels,2015,
3075,48,12,36,0,Prem Ratan Dhan Payo,2015,
3076,10,4,6,0,Puli,2015,
3077,11,6,5,0,Pyaar Ka Punchnama 2,2015,
3078,19,6,13,0,Rahasya,2015,
3079,7,1,6,0,Ranbanka,2015,
3080,43,13,30,0,Ranna,2015,
3081,11,3,8,0,Roy,2015,
3082,32,7,25,0,Rudhramadevi,2015,
3083,28,10,18,0,S/O Satyamurthy,2015,
3084,14,6,8,0,Second Hand Husband,2015,
3085,26,12,14,0,Shaandaar,2015,
3086,55,22,33,0,Shamitabh,2015,
3087,5,2,3,0,Sharafat Gayi Tel Lene,2015,
3088,18,6,12,0,Singh Is Bliing,2015,
3089,22,5,17,0,Talvar,2015,
3090,15,4,11,0,Tamasha,2015,
3091,13,2,11,0,Tanu Weds Manu Returns,2015,
3092,13,4,9,0,Tevar,2015,
3093,9,3,6,0,The Bright Day,2015,
3094,76,22,54,0,The Challenger,2015,
3095,11,3,8,0,The Perfect Girl,2015,
3096,8,4,4,0,The Silence,2015,
3097,12,1,11,0,The Silent Heroes,2015,
3098,11,1,10,0,Time Out,2015,
3099,114,32,82,0,Train Station,2015,
3100,47,10,37,0,Umrika,2015,
3101,21,5,16,0,Utopia,2015,
3102,26,10,16,0,Uvaa,2015,
3103,9,4,5,0,Waiting,2015,
3104,11,7,4,0,Wedding Pullav,2015,
3105,22,7,15,0,Welcome Back,2015,
3106,50,13,37,0,Welcome to Karachi,2015,
3107,13,12,1,0,X: Past Is Present,2015,
3108,28,9,19,0,Xun Long Jue,2015,
3109,5,3,2,0,Yaara Silly Silly,2015,
3110,17,4,13,0,Zubaan,2015,
3111,25,11,14,0,1920 London,2016,
3112,10,4,6,0,1:13:7 Ek Tera Saath,2016,
3113,12,2,10,0,7 Hours to Go,2016,
3114,19,10,9,0,A Death in the Gunj,2016,
3115,9,4,5,0,A Flying Jatt,2016,
3116,7,3,4,0,A Scandall,2016,
3117,14,5,9,0,Aadupuliyattam,2016,
3118,79,44,35,0,Ae Dil Hai Mushkil,2016,
3119,45,14,31,0,Airlift,2016,
3120,41,16,25,0,Akira,2016,
3121,6,1,5,0,Autohead,2016,
3122,56,17,39,0,Azhar,2016,
3123,17,1,16,0,Baaghi,2016,
3124,65,12,53,0,Baar Baar Dekho,2016,
3125,13,4,9,0,Banjo,2016,
3126,42,21,21,0,Befikre,2016,
3127,6,2,4,0,Beiimaan Love,2016,
3128,12,3,9,0,Bhouri,2016,
3129,27,10,17,0,Bollywood Diaries,2016,
3130,6,3,3,0,Buddha in a Traffic Jam,2016,
3131,10,4,6,0,Budhia Singh: Born to Run,2016,
3132,169,34,135,0,Captain America: Civil War,2016,
3133,1,0,1,0,Chaar Sahibzaade 2: Rise of Banda Singh Bahadur,2016,
3134,14,8,6,0,Chalk N Duster,2016,
3135,13,3,10,0,Chhota Bheem Himalayan Adventure,2016,
3136,13,3,10,0,Chudail Story,2016,
3137,6,2,4,0,Crd,2016,
3138,21,6,15,0,Dangal,2016,
3139,7,3,4,0,Days of Tafree,2016,
3140,6,2,4,0,Dear Dad,2016,
3141,54,16,38,0,Dear Zindagi,2016,
3142,32,9,23,0,Dev Bhoomi,2016,
3143,15,4,11,0,Dhruva,2016,
3144,8,1,7,0,Direct Ishq,2016,
3145,50,8,42,0,Dishoom,2016,
3146,6,1,5,0,Do Lafzon Ki Kahani,2016,
3147,9,2,7,0,Dongri Ka Raja,2016,
3148,126,41,85,0,Fan,2016,
3149,6,4,2,0,Fever,2016,
3150,21,10,11,0,Fitoor,2016,
3151,17,2,15,0,Force 2,2016,
3152,26,6,20,0,Freaky Ali,2016,
3153,16,6,10,0,Fuddu,2016,
3154,2,0,2,0,Gauru: Journey of Courage,2016,
3155,28,11,17,0,Ghayal Once Again,2016,
3156,4,1,3,0,Global Baba,2016,
3157,28,12,16,0,Great Grand Masti,2016,
3158,21,5,16,0,Happy Bhag Jayegi,2016,
3159,9,4,5,0,Hello Mumbai: Salaam Mumbai,2016,
3160,7,3,4,0,Hotel Salvation,2016,
3161,128,58,70,0,Housefull 3,2016,
3162,6,2,4,0,Ishq Click,2016,
3163,9,2,7,0,Ishq Forever,2016,
3164,23,5,18,0,Jai Gangaajal,2016,
3165,9,5,4,0,Jugni,2016,
3166,40,19,21,0,Junooniyat,2016,
3167,51,7,44,0,Kabali,2016,
3168,19,6,13,0,Kahaani 2,2016,
3169,23,6,17,0,Kammatti Paadam,2016,
3170,35,9,26,0,Kapoor & Sons,2016,
3171,9,2,7,0,Kerry on Kutton,2016,
3172,18,7,11,0,Ki & Ka,2016,
3173,17,7,10,0,Kyaa Kool Hain Hum 3,2016,
3174,9,2,7,0,Laal Rang,2016,
3175,40,18,22,0,Lion,2016,
3176,60,21,39,0,Lipstick Under My Burkha,2016,
3177,16,5,11,0,Love Games,2016,
3178,43,17,26,0,Love Shagun,2016,
3179,32,14,18,0,LoveShhuda,2016,
3180,30,6,24,0,M.S. Dhoni: The Untold Story,2016,
3181,7,2,5,0,MSG the Warrior: Lion Heart,2016,
3182,28,2,26,0,Madaari,2016,
3183,15,9,6,0,Madly,2016,
3184,7,2,5,0,Mantostaan,2016,
3185,6,1,5,0,Maroon,2016,
3186,36,14,22,0,Mastizaade,2016,
3187,7,2,5,0,Mirzya,2016,
3188,7,2,5,0,Miss Teacher,2016,
3189,10,3,7,0,Missing on a Weekend,2016,
3190,6,3,3,0,Moh Maya Money,2016,
3191,42,5,37,0,Mohenjo Daro,2016,
3192,2,0,2,0,Motu Patlu: King of Kings,2016,
3193,7,0,7,0,Nagarahavu,2016,
3194,60,25,35,0,Neerja,2016,
3195,19,6,13,0,One Night Stand,2016,
3196,7,4,3,0,Phobia,2016,
3197,27,10,17,0,Pink,2016,
3198,11,4,7,0,Raaz Reboot,2016,
3199,19,3,16,0,Railway Children,2016,
3200,22,7,15,0,Raman Raghav 2.0,2016,
3201,19,5,14,0,Rebellious Flower,2016,
3202,15,3,12,0,Rock On 2,2016,
3203,40,10,30,0,Rocky Handsome,2016,
3204,12,4,8,0,Rough Book,2016,
3205,33,7,26,0,Rustom,2016,
3206,15,4,11,0,Saala Khadoos,2016,
3207,6,2,4,0,Saansein: The Last Breath,2016,
3208,21,4,17,0,Saat Uchakkey,2016,
3209,21,9,12,0,Sanam Re,2016,
3210,31,14,17,0,Sanam Teri Kasam,2016,
3211,18,4,14,0,Santa Banta Pvt Ltd,2016,
3212,53,11,42,0,Sarbjit,2016,
3213,31,6,25,0,Sardaar Gabbar Singh,2016,
3214,18,5,13,0,Sarrainodu,2016,
3215,34,7,27,0,Shivaay,2016,
3216,15,5,10,0,Shor Se Shuruaat,2016,
3217,16,4,12,0,Shorgul,2016,
3218,12,7,5,0,Six X,2016,
3219,20,10,10,0,Sold,2016,
3220,42,9,33,0,Sultan,2016,
3221,25,6,19,0,Te3n,2016,
3222,9,3,6,0,Teraa Surroor,2016,
3223,24,2,22,0,Tere Bin Laden: Dead Or Alive,2016,
3224,9,2,7,0,The Blueberry Hunt,2016,
3225,22,4,18,0,The Other Side of the Door,2016,
3226,5,1,4,0,The Violin Player,2016,
3227,19,4,15,0,Thikka,2016,
3228,14,5,9,0,Traffic,2016,
3229,16,2,14,0,Trapped,2016,
3230,12,5,7,0,Tu Hai Mera Sunday,2016,
3231,24,13,11,0,Tum Bin 2,2016,
3232,12,4,8,0,Tutak Tutak Tutiya,2016,
3233,83,11,72,0,Udta Punjab,2016,
3234,12,3,9,0,Veerappan,2016,
3235,18,4,14,0,Wah Taj,2016,
3236,28,12,16,0,Wajah Tum Ho,2016,
3237,10,3,7,0,Warrior Savitri,2016,
3238,43,19,24,0,Wazir,2016,
3239,14,7,7,0,Yea Toh Two Much Ho Gayaa,2016,
3240,8,3,5,0,1982 - A Love Marriage,2017,
3241,29,6,23,0,A Gentleman,2017,
3242,16,5,11,0,Aa Gaya Hero,2017,
3243,17,10,7,0,Ajji,2017,
3244,9,3,6,0,Aksar 2,2017,
3245,10,3,7,0,Alif,2017,
3246,10,3,7,0,Amazon Obhijaan,2017,
3247,7,3,4,0,Anaarkali of Aarah,2017,
3248,8,3,5,0,B.A. Pass 2,2017,
3249,15,5,10,0,Baadshaho,2017,
3250,21,5,16,0,Baahubali 2: The Conclusion,2017,
3251,14,3,11,0,Baaraat Company,2017,
3252,16,5,11,0,Babumoshai Bandookbaaz,2017,
3253,72,28,44,0,Badrinath Ki Dulhania,2017,
3254,16,4,12,0,Bairavaa,2017,
3255,9,3,6,0,Balu Mahi,2017,
3256,28,5,23,0,Bank Chor,2017,
3257,8,4,4,0,Bareilly Ki Barfi,2017,
3258,22,10,12,0,Begum Jaan,2017,
3259,11,2,9,0,Behen Hogi Teri,2017,
3260,15,6,9,0,Beyond the Clouds,2017,
3261,43,10,33,0,Bhoomi,2017,
3262,10,3,7,0,Brij Mohan Amar Rahe,2017,
3263,46,9,37,0,Chef,2017,
3264,54,12,42,0,Commando 2,2017,
3265,41,16,25,0,Crash Test Aglaé,2017,
3266,116,14,102,0,Daddy,2017,
3267,14,3,11,0,Dark wind,2017,
3268,10,5,5,0,Dear Maya,2017,
3269,15,6,9,0,Dobaara: See Your Evil,2017,
3270,6,1,5,0,Dora,2017,
3271,34,9,25,0,Duvvada Jagannadham,2017,
3272,24,7,17,0,Ek Haseena Thi Ek Deewana Tha,2017,
3273,14,4,10,0,Firangi,2017,
3274,45,10,35,0,Fukrey Returns,2017,
3275,7,1,6,0,Gali Guleiyan,2017,
3276,15,3,12,0,Game Over,2017,
3277,162,42,120,0,Geostorm,2017,
3278,25,5,20,0,Golmaal Again,2017,
3279,56,30,26,0,Gospel Movie: Who Is My Lord,2017,
3280,94,52,42,0,Guest iin London,2017,
3281,9,3,6,0,Gurgaon,2017,
3282,58,13,45,0,Gyakusatsu kikan,2017,
3283,12,5,7,0,Half Girlfriend,2017,
3284,16,3,13,0,Hanuman Da' Damdaar,2017,
3285,8,1,7,0,Hind Ka Napak Ko Jawab,2017,
3286,63,20,43,0,Hindi Medium,2017,
3287,21,7,14,0,III Smoking Barrels,2017,
3288,16,5,11,0,Indu Sarkar,2017,
3289,18,9,9,0,Irada,2017,
3290,24,6,18,0,Ittefaq,2017,
3291,21,7,14,0,Jab Harry Met Sejal,2017,
3292,22,3,19,0,Jagga Jasoos,2017,
3293,14,0,14,0,Jattu Engineer,2017,
3294,29,12,17,0,Jeena Isi Ka Naam Hai,2017,
3295,11,5,6,0,Jia aur Jia,2017,
3296,44,6,38,0,Jolly LLB 2,2017,
3297,100,44,56,0,Judwaa 2,2017,
3298,22,3,19,0,Julie 2,2017,
3299,16,4,12,0,Kaabil,2017,
3300,6,2,4,0,Kadamban,2017,
3301,6,1,5,0,Khoj,2017,
3302,13,4,9,0,Kuldip Patwal: I Didn't Do It!,2017,
3303,30,6,24,0,LIE,2017,
3304,9,3,6,0,Laali Ki Shaadi Mein Laaddoo Deewana,2017,
3305,14,4,10,0,Love and Shukla,2017,
3306,18,2,16,0,Lucknow Central,2017,
3307,15,3,12,0,Maatr,2017,
3308,15,5,10,0,Machine,2017,
3309,70,12,58,0,Meri Pyaari Bindu,2017,
3310,22,8,14,0,Mersal,2017,
3311,21,10,11,0,Mirror Game,2017,
3312,6,1,5,0,Mirza Juuliet,2017,
3313,14,5,9,0,Mom,2017,
3314,108,50,58,0,Mubarakan,2017,
3315,12,3,9,0,Mukkabaaz,2017,
3316,19,7,12,0,Munna Michael,2017,
3317,20,5,15,0,Naam Shabana,2017,
3318,55,14,41,0,Newton,2017,
3319,41,16,25,0,Noor,2017,
3320,38,13,25,0,OK Jaanu,2017,
3321,17,3,14,0,Omerta,2017,
3322,38,14,24,0,One Less God,2017,
3323,25,7,18,0,Patel Ki Punjabi Shaadi,2017,
3324,31,9,22,0,Phillauri,2017,
3325,4,2,2,0,Phullu,2017,
3326,37,11,26,0,Poorna,2017,
3327,38,12,26,0,Poster Boys,2017,
3328,12,5,7,0,Qarib Qarib Singlle,2017,
3329,21,6,15,0,Raabta,2017,
3330,27,1,26,0,Raag Desh,2017,
3331,79,12,67,0,Raees,2017,
3332,6,1,5,0,Ranchi Diaries,2017,
3333,30,6,24,0,Rangoon,2017,
3334,9,4,5,0,Ribbon,2017,
3335,14,2,12,0,Rukh,2017,
3336,8,2,6,0,Running Shaadi,2017,
3337,10,5,5,0,Saanjh,2017,
3338,9,2,7,0,Sameer,2017,
3339,12,3,9,0,Sarkar 3,2017,
3340,9,5,4,0,Secret Superstar,2017,
3341,13,5,8,0,Shaadi Mein Zaroor Aana,2017,
3342,8,2,6,0,Shab,2017,
3343,18,5,13,0,Shubh Mangal Saavdhan,2017,
3344,43,10,33,0,Shuddhi,2017,
3345,55,18,37,0,Simran,2017,
3346,10,3,7,0,Sniff!!!,2017,
3347,15,4,11,0,Sweetiee Weds NRI,2017,
3348,6,4,2,0,Tera Intezaar,2017,
3349,22,1,21,0,The Ghazi Attack,2017,
3350,8,2,6,0,The House Next Door,2017,
3351,5,3,2,0,The Rally,2017,
3352,7,4,3,0,The Song of Scorpions,2017,
3353,18,12,6,0,The Wishing Tree,2017,
3354,68,5,63,0,Thupparivaalan,2017,
3355,50,10,40,0,Tiger Zinda Hai,2017,
3356,14,6,8,0,Tikli and Laxmi Bomb,2017,
3357,19,5,14,0,Toilet - Ek Prem Katha,2017,
3358,54,5,49,0,Tubelight,2017,
3359,41,13,28,0,Tumhari Sulu,2017,
3360,28,3,25,0,Union Leader,2017,
3361,8,3,5,0,Veeram,2017,
3362,60,13,47,0,Viceroy's House,2017,
3363,64,11,53,0,Victoria & Abdul,2017,
3364,20,4,16,0,Vikram Vedha,2017,
3365,19,11,8,0,Wedding Anniversary,2017,
3366,12,1,11,0,102 Not Out,2018,
3367,70,29,41,0,1921,2018,
3368,14,6,8,0,3 Storeys,2018,
3369,4,2,2,0,Aadamkhor,2018,
3370,82,26,56,0,Aiyaary,2018,
3371,15,6,9,0,Andhadhun,2018,
3372,12,2,10,0,Angrezi Mein Kehte Hain,2018,
3373,17,3,14,0,Baaghi 2,2018,
3374,3,1,2,0,Baarish Aur Chowmein,2018,
3375,16,4,12,0,Baazaar,2018,
3376,12,7,5,0,Badhaai Ho,2018,
3377,22,7,15,0,Batti Gul Meter Chalu,2018,
3378,18,6,12,0,Bhaiaji Superhit,2018,
3379,12,2,10,0,Bhavesh Joshi Superhero,2018,
3380,29,9,20,0,Bioscopewala,2018,
3381,37,10,27,0,Blackmail,2018,
3382,12,4,8,0,Daas Dev,2018,
3383,33,8,25,0,Dhadak,2018,
3384,32,10,22,0,Dil Juunglee,2018,
3385,34,9,25,0,FryDay,2018,
3386,6,4,2,0,Garbage,2018,
3387,12,2,10,0,Genius,2018,
3388,208,35,173,0,Gold,2018,
3389,4,1,3,0,Halkaa,2018,
3390,12,3,9,0,Happy Phirr Bhag Jayegi,2018,
3391,3,1,2,0,Haseena,2018,
3392,68,31,37,0,Hate Story IV,2018,
3393,11,3,8,0,Helicopter Eela,2018,
3394,4,2,2,0,Hey Ram Hamne Gandhi Ko maar Diya,2018,
3395,65,19,46,0,Hichki,2018,
3396,18,2,16,0,High Jack,2018,
3397,8,5,3,0,Hope Aur Hum,2018,
3398,34,10,24,0,Hotel Mumbai,2018,
3399,13,6,7,0,Jalebi,2018,
3400,18,6,12,0,Kaalakaandi,2018,
3401,14,3,11,0,Kaashi in Search of Ganga,2018,
3402,26,9,17,0,Karwaan,2018,
3403,11,4,7,0,Kedarnath,2018,
3404,15,5,10,0,Khajoor Pe Atke,2018,
3405,15,6,9,0,Kuchh Bheege Alfaaz,2018,
3406,8,3,5,0,Laila Majnu,2018,
3407,2,1,1,0,Leera the Soulmate,2018,
3408,35,11,24,0,Love Per Square Foot,2018,
3409,39,22,17,0,Love Sonia,2018,
3410,24,7,17,0,Loveyatri,2018,
3411,9,5,4,0,Lupt,2018,
3412,13,5,8,0,Lust Stories,2018,
3413,18,7,11,0,Manmarziyaan,2018,
3414,77,19,58,0,Manto,2018,
3415,4,1,3,0,Mard Ko Dard Nahin Hota,2018,
3416,28,11,17,0,Meri Nimmo,2018,
3417,15,5,10,0,Missing,2018,
3418,17,3,14,0,Mitron,2018,
3419,36,5,31,0,Mowgli,2018,
3420,14,5,9,0,Mulk,2018,
3421,7,4,3,0,My Birthday Song,2018,
3422,43,14,29,0,Namaste England,2018,
3423,15,2,13,0,Nanu Ki Jaanu,2018,
3424,48,10,38,0,Nawabzaade,2018,
3425,4,2,2,0,Nirdosh,2018,
3426,216,107,109,0,Ocean's Eight,2018,
3427,70,28,42,0,October,2018,
3428,7,3,4,0,Once Again,2018,
3429,45,9,36,0,Padmaavat,2018,
3430,34,11,23,0,Padman,2018,
3431,15,4,11,0,Paltan,2018,
3432,36,10,26,0,Pari,2018,
3433,20,2,18,0,Parmanu: The Story of Pokhran,2018,
3434,33,4,29,0,Pataakha,2018,
3435,21,5,16,0,Phamous,2018,
3436,8,4,4,0,Phir Se...,2018,
3437,2,2,0,0,Pihu,2018,
3438,70,16,54,0,Raazi,2018,
3439,49,7,42,0,Race 3,2018,
3440,14,4,10,0,Raid,2018,
3441,15,5,10,0,Rajma Chawal,2018,
3442,21,8,13,0,Saheb Biwi Aur Gangster 3,2018,
3443,34,9,25,0,Sanju,2018,
3444,51,11,40,0,Satyameva Jayate,2018,
3445,10,2,8,0,Shaadi Teri Bajayenge Hum Band,2018,
3446,32,7,25,0,Shohrat the Trap,2018,
3447,4,2,2,0,Silvat,2018,
3448,5,3,2,0,Sir,2018,
3449,14,6,8,0,Soni,2018,
3450,30,12,18,0,Sonu Ke Titu Ki Sweety,2018,
3451,17,4,13,0,Soorma,2018,
3452,13,4,9,0,Stree,2018,
3453,20,5,15,0,Subedar Joginder Singh,2018,
3454,14,4,10,0,Sui Dhaaga: Made in India,2018,
3455,12,4,8,0,T for Taj Mahal,2018,
3456,5,2,3,0,Teen Aur Aadha,2018,
3457,5,2,3,0,Teri Bhabhi Hai Pagle,2018,
3458,9,4,5,0,The Dark Side of Life: Mumbai City,2018,
3459,43,4,39,0,Thugs of Hindostan,2018,
3460,57,14,43,0,Tomb Raider,2018,
3461,14,3,11,0,Tumbbad,2018,
3462,0,0,0,0,Vaibhav Sethia: Don't,2018,
3463,24,13,11,0,Veere Di Wedding,2018,
3464,30,13,17,0,Veerey Ki Wedding,2018,
3465,13,2,11,0,Vishwaroopam 2,2018,
3466,25,4,21,0,Vodka Diaries,2018,
3467,44,18,26,0,Welcome to New York,2018,
3468,7,2,5,0,Who,2018,
3469,14,4,10,0,Yamla Pagla Deewana Phir Se...,2018,
